coachid,year,yr_order,firstname,lastname,season_win,season_loss,playoff_win,playoff_loss,team,Total seasons played,Ttoal playoff played,percentage season win,percentage playoff win,AVG,Less Greater,Total wins,Total Matches
RUSSEJO01 ,1946,1,John,Russell,22,38,0,0,BOS,60,0,36.66666667,#DIV/0!,#DIV/0!,#DIV/0!,22,60
CUNNIBI01 ,1982,1,Billy,Cunningham,65,17,12,1,PHI,82,13,79.26829268,92.30769231,85.7879925,1,77,95
DEHNEDU01 ,1946,1,Dutch,Dehnert,17,20,0,0,CL1,37,0,45.94594595,#DIV/0!,#DIV/0!,#DIV/0!,17,37
JACKSPH01 ,1995,1,Phil,Jackson,72,10,15,3,CHI,82,18,87.80487805,83.33333333,85.56910569,1,87,100
CURTIGL01 ,1946,1,Glenn,Curtis,12,22,0,0,DE1,34,0,35.29411765,#DIV/0!,#DIV/0!,#DIV/0!,12,34
SACHSPH01 ,1946,1,Philip,Sachs,8,18,0,0,DE1,26,0,30.76923077,#DIV/0!,#DIV/0!,#DIV/0!,8,26
COSTELA01 ,1970,1,Larry,Costello,66,16,12,2,MIL,82,14,80.48780488,85.71428571,83.1010453,1,78,96
DALYCH01  ,1988,1,Chuck,Daly,63,19,15,2,DET,82,17,76.82926829,88.23529412,82.53228121,1,78,99
BIRCHPA01 ,1946,1,Paul,Birch,15,45,0,0,PIT,60,0,25,#DIV/0!,#DIV/0!,#DIV/0!,15,60
MORRIRO01 ,1946,1,Robert,Morris,28,32,0,0,PRO,60,0,46.66666667,#DIV/0!,#DIV/0!,#DIV/0!,28,60
JONESKC01 ,1985,1,KC,Jones,67,15,15,3,BOS,82,18,81.70731707,83.33333333,82.5203252,1,82,100
FITZGDI01 ,1946,1,Dick,Fitzgerald,2,1,0,0,TO1,3,0,66.66666667,#DIV/0!,#DIV/0!,#DIV/0!,2,3
SADOWED01 ,1946,2,Ed,Sadowski,3,9,0,0,TO1,12,0,25,#DIV/0!,#DIV/0!,#DIV/0!,3,12
HAYMALE01 ,1946,3,Lew,Hayman,0,1,0,0,TO1,1,0,0,#DIV/0!,#DIV/0!,#DIV/0!,0,1
ROLFERO01 ,1946,4,Robert,Rolfe,17,27,0,0,TO1,44,0,38.63636364,#DIV/0!,#DIV/0!,#DIV/0!,17,44
SHARMBI01 ,1971,1,Bill,Sharman,69,13,12,3,LAL,82,15,84.14634146,80,82.07317073,1,81,97
JACKSPH01 ,1996,1,Phil,Jackson,69,13,15,4,CHI,82,19,84.14634146,78.94736842,81.54685494,1,84,101
JACKSPH01 ,1990,1,Phil,Jackson,61,21,15,2,CHI,82,17,74.3902439,88.23529412,81.31276901,1,76,99
RILEYPA01 ,1986,1,Pat,Riley,65,17,15,3,LAL,82,18,79.26829268,83.33333333,81.30081301,1,80,100
POPOVGR01 ,1998,1,Gregg,Popovich,37,13,15,2,SAS,50,17,74,88.23529412,81.11764706,1,52,67
JACKSPH01 ,2000,1,Phil,Jackson,56,26,15,1,LAL,82,16,68.29268293,93.75,81.02134146,1,71,98
HICKENA01 ,1947,1,Nat,Hickey,4,25,0,0,PRO,29,0,13.79310345,#DIV/0!,#DIV/0!,#DIV/0!,4,29
SOARAL01  ,1947,2,Albert,Soar,2,17,0,0,PRO,19,0,10.52631579,#DIV/0!,#DIV/0!,#DIV/0!,2,19
KUNDLJO01 ,1949,1,John,Kundla,51,17,10,2,MIE,68,12,75,83.33333333,79.16666667,1,61,80
AUERBRE01 ,1947,1,Red,Auerbach,28,20,0,0,WSC,48,0,58.33333333,#DIV/0!,#DIV/0!,#DIV/0!,28,48
HANNUAL01 ,1966,1,Alex,Hannum,68,13,11,4,PHI,81,15,83.95061728,73.33333333,78.64197531,1,79,96
JULIAAL01 ,1948,1,Alvin,Julian,25,35,0,0,BOS,60,0,41.66666667,#DIV/0!,#DIV/0!,#DIV/0!,25,60
OLSENHA01 ,1948,1,Harold,Olsen,28,21,0,2,CH1,49,2,57.14285714,0,28.57142857,0,28,51
BROWNPH01 ,1948,2,Philip,Brownstein,10,1,0,0,CH1,11,0,90.90909091,#DIV/0!,#DIV/0!,#DIV/0!,10,11
BENNECA01 ,1948,1,Carl,Bennett,0,6,0,0,DET,6,0,0,#DIV/0!,#DIV/0!,#DIV/0!,0,6
ARMSTPA01 ,1948,2,Paul,Armstrong,22,32,0,0,DET,54,0,40.74074074,#DIV/0!,#DIV/0!,#DIV/0!,22,54
HALEBR01  ,1948,1,Bruce,Hale,4,13,0,0,INJ,17,0,23.52941176,#DIV/0!,#DIV/0!,#DIV/0!,4,17
FRIDDBU01 ,1948,2,Burl,Friddle,14,29,0,0,INJ,43,0,32.55813953,#DIV/0!,#DIV/0!,#DIV/0!,14,43
RILEYPA01 ,1981,2,Pat,Riley,50,21,12,2,LAL,71,14,70.42253521,85.71428571,78.06841046,1,62,85
RILEYPA01 ,1984,1,Pat,Riley,62,20,15,4,LAL,82,19,75.6097561,78.94736842,77.27856226,1,77,101
GOTTLED01 ,1948,1,Eddie,Gottlieb,28,32,0,2,PH1,60,2,46.66666667,0,23.33333333,0,28,62
LOEFFKE01 ,1948,1,Ken,Loeffler,12,48,0,0,PRO,60,0,20,#DIV/0!,#DIV/0!,#DIV/0!,12,60
AUERBRE01 ,1963,1,Red,Auerbach,59,21,8,2,BOS,80,10,73.75,80,76.875,1,67,90
LEWISGR01 ,1948,1,Grady,Lewis,29,31,0,2,ST1,60,2,48.33333333,0,24.16666667,0,29,62
KUNDLJO01 ,1948,1,John,Kundla,44,16,8,2,MIE,60,10,73.33333333,80,76.66666667,1,52,70
SCHULHO01 ,1949,1,Howie,Schultz,21,14,0,0,AND,35,0,60,#DIV/0!,#DIV/0!,#DIV/0!,21,35
DUFFEIK01 ,1949,2,Ike,Duffey,1,2,0,0,AND,3,0,33.33333333,#DIV/0!,#DIV/0!,#DIV/0!,1,3
AUERBRE01 ,1960,1,Red,Auerbach,57,22,8,2,BOS,79,10,72.15189873,80,76.07594937,1,65,89
JEANNBU01 ,1949,1,Buddy,Jeannette,25,43,0,0,BA1,68,0,36.76470588,#DIV/0!,#DIV/0!,#DIV/0!,25,68
JULIAAL01 ,1949,1,Alvin,Julian,22,46,0,0,BOS,68,0,32.35294118,#DIV/0!,#DIV/0!,#DIV/0!,22,68
BROWNPH01 ,1949,1,Philip,Brownstein,40,28,0,3,CH1,68,3,58.82352941,0,29.41176471,0,40,71
JACKSPH01 ,1991,1,Phil,Jackson,67,15,15,7,CHI,82,22,81.70731707,68.18181818,74.94456763,1,82,104
DARDEJI01 ,1949,1,Jimmy,Darden,11,51,0,0,DN1,62,0,17.74193548,#DIV/0!,#DIV/0!,#DIV/0!,11,62
JACKSPH01 ,2001,1,Phil,Jackson,58,24,15,4,LAL,82,19,70.73170732,78.94736842,74.83953787,1,73,101
WESTHPA01 ,1979,2,Paul,Westhead,50,18,12,4,LAL,68,16,73.52941176,75,74.26470588,1,62,84
JACKSPH01 ,1992,1,Phil,Jackson,57,25,15,4,CHI,82,19,69.51219512,78.94736842,74.22978177,1,72,101
GOTTLED01 ,1949,1,Eddie,Gottlieb,26,42,0,2,PH1,68,2,38.23529412,0,19.11764706,0,26,70
HARRILE01 ,1949,1,Les,Harrison,51,17,0,2,ROC,68,2,75,0,37.5,0,51,70
JACKSPH01 ,1997,1,Phil,Jackson,62,20,15,6,CHI,82,21,75.6097561,71.42857143,73.51916376,1,77,103
LEWISGR01 ,1949,1,Grady,Lewis,26,42,0,0,ST1,68,0,38.23529412,#DIV/0!,#DIV/0!,#DIV/0!,26,68
DALYCH01  ,1989,1,Chuck,Daly,59,23,15,5,DET,82,20,71.95121951,75,73.47560976,1,74,102
JACKSPH01 ,1999,1,Phil,Jackson,67,15,15,8,LAL,82,23,81.70731707,65.2173913,73.46235419,1,82,105
POTTERO01 ,1949,2,Roger,Potter,1,6,0,0,TRI,7,0,14.28571429,#DIV/0!,#DIV/0!,#DIV/0!,1,7
SHIPPCH01 ,1949,1,Charley,Shipp,8,27,0,0,WAT,35,0,22.85714286,#DIV/0!,#DIV/0!,#DIV/0!,8,35
SMILEJA01 ,1949,2,Jack,Smiley,11,16,0,0,WAT,27,0,40.74074074,#DIV/0!,#DIV/0!,#DIV/0!,11,27
FEERIBO01 ,1949,1,Bob,Feerick,32,36,0,2,WSC,68,2,47.05882353,0,23.52941176,0,32,70
JEANNBU01 ,1950,1,Buddy,Jeannette,14,23,0,0,BA1,37,0,37.83783784,#DIV/0!,#DIV/0!,#DIV/0!,14,37
BUDKOWA01 ,1950,2,Walt,Budko,10,19,0,0,BA1,29,0,34.48275862,#DIV/0!,#DIV/0!,#DIV/0!,10,29
AUERBRE01 ,1950,1,Red,Auerbach,39,30,0,2,BOS,69,2,56.52173913,0,28.26086957,0,39,71
FITCHBI01 ,1980,1,Bill,Fitch,62,20,12,5,BOS,82,17,75.6097561,70.58823529,73.0989957,1,74,99
BARKECL01 ,1950,1,Cliff,Barker,24,32,0,0,INI,56,0,42.85714286,#DIV/0!,#DIV/0!,#DIV/0!,24,56
AUERBRE01 ,1958,1,Red,Auerbach,52,20,8,3,BOS,72,11,72.22222222,72.72727273,72.47474747,1,60,83
AUERBRE01 ,1964,1,Red,Auerbach,62,18,8,4,BOS,80,12,77.5,66.66666667,72.08333333,1,70,92
KUNDLJO01 ,1952,1,John,Kundla,48,22,9,3,MIE,70,12,68.57142857,75,71.78571429,1,57,82
GOTTLED01 ,1950,1,Eddie,Gottlieb,40,26,0,2,PH1,66,2,60.60606061,0,30.3030303,0,40,68
SLOANJE01 ,1996,1,Jerry,Sloan,64,18,13,7,UTA,82,20,78.04878049,65,71.52439024,1,77,102
RILEYPA01 ,1988,1,Pat,Riley,57,25,11,4,LAL,82,15,69.51219512,73.33333333,71.42276423,1,68,97
LOGANJO01 ,1950,1,John,Logan,2,1,0,0,TRI,3,0,66.66666667,#DIV/0!,#DIV/0!,#DIV/0!,2,3
TODORMI01 ,1950,1,Mike,Todorovich,14,28,0,0,TRI,42,0,33.33333333,#DIV/0!,#DIV/0!,#DIV/0!,14,42
MCMILDA01 ,1950,1,Dave,McMillan,9,14,0,0,TRI,23,0,39.13043478,#DIV/0!,#DIV/0!,#DIV/0!,9,23
MCKINHO01 ,1950,1,Horace,McKinney,10,25,0,0,WSC,35,0,28.57142857,#DIV/0!,#DIV/0!,#DIV/0!,10,35
SCOLAFR01 ,1951,1,Fred,Scolari,12,27,0,0,BA1,39,0,30.76923077,#DIV/0!,#DIV/0!,#DIV/0!,12,39
REISECH01 ,1951,2,Chuck,Reiser,8,19,0,0,BA1,27,0,29.62962963,#DIV/0!,#DIV/0!,#DIV/0!,8,27
JONESKC01 ,1983,1,KC,Jones,62,20,15,8,BOS,82,23,75.6097561,65.2173913,70.4135737,1,77,105
BIRCHPA01 ,1951,1,Paul,Birch,29,37,0,2,DET,66,2,43.93939394,0,21.96969697,0,29,68
SCHAEHE01 ,1951,1,Herm,Schaefer,34,32,0,2,INI,66,2,51.51515152,0,25.75757576,0,34,68
MOOREDO01 ,1951,1,Doxie,Moore,17,49,0,0,MI1,66,0,25.75757576,#DIV/0!,#DIV/0!,#DIV/0!,17,66
COSTELA01 ,1973,1,Larry,Costello,59,23,11,5,MIL,82,16,71.95121951,68.75,70.35060976,1,70,98
SLOANJE01 ,1997,1,Jerry,Sloan,62,20,13,7,UTA,82,20,75.6097561,65,70.30487805,1,75,102
AUERBRE01 ,1959,1,Red,Auerbach,59,16,8,5,BOS,75,13,78.66666667,61.53846154,70.1025641,1,67,88
HOLZMRE01 ,1972,1,Red,Holzman,57,25,12,5,NYK,82,17,69.51219512,70.58823529,70.05021521,1,69,99
KARLGE01  ,1995,1,George,Karl,64,18,13,8,SEA,82,21,78.04878049,61.9047619,69.9767712,1,77,103
REISECH01 ,1952,1,Chuck,Reiser,0,3,0,0,BA1,3,0,0,#DIV/0!,#DIV/0!,#DIV/0!,0,3
BEECL01   ,1952,2,Clair,Bee,16,51,0,0,BA1,67,0,23.88059701,#DIV/0!,#DIV/0!,#DIV/0!,16,67
POPOVGR01 ,2002,1,Gregg,Popovich,60,22,16,8,SAS,82,24,73.17073171,66.66666667,69.91869919,1,76,106
JONESKC01 ,1984,1,KC,Jones,63,19,13,8,BOS,82,21,76.82926829,61.9047619,69.3670151,1,76,103
SCHAEHE01 ,1952,1,Herm,Schaefer,28,43,0,2,INI,71,2,39.43661972,0,19.71830986,0,28,73
LEVANAN01 ,1952,1,Andrew,Levane,27,44,0,0,MI1,71,0,38.02816901,#DIV/0!,#DIV/0!,#DIV/0!,27,71
CUNNIBI01 ,1979,1,Billy,Cunningham,59,23,12,6,PHI,82,18,71.95121951,66.66666667,69.30894309,1,71,100
GOTTLED01 ,1946,1,Eddie,Gottlieb,35,25,8,2,PH1,60,10,58.33333333,80,69.16666667,1,43,70
GOTTLED01 ,1952,1,Eddie,Gottlieb,12,57,0,0,PH1,69,0,17.39130435,#DIV/0!,#DIV/0!,#DIV/0!,12,69
RILEYPA01 ,1987,1,Pat,Riley,62,20,15,9,LAL,82,24,75.6097561,62.5,69.05487805,1,77,106
CERVIAL01 ,1952,1,Al,Cervi,47,24,0,2,SYR,71,2,66.1971831,0,33.09859155,0,47,73
BEECL01   ,1953,1,Clair,Bee,16,56,0,0,BA1,72,0,22.22222222,#DIV/0!,#DIV/0!,#DIV/0!,16,72
ADELMRI01 ,2001,1,Rick,Adelman,61,21,10,6,SAC,82,16,74.3902439,62.5,68.44512195,1,71,98
BIRCHPA01 ,1953,1,Paul,Birch,40,32,0,4,DET,72,4,55.55555556,0,27.77777778,0,40,76
LEVANAN01 ,1953,1,Andrew,Levane,11,35,0,0,MI1,46,0,23.91304348,#DIV/0!,#DIV/0!,#DIV/0!,11,46
HOLZMRE01 ,1953,2,Red,Holzman,10,16,0,0,MI1,26,0,38.46153846,#DIV/0!,#DIV/0!,#DIV/0!,10,26
CARLIRI01 ,2003,1,Rick,Carlisle,61,21,10,6,IND,82,16,74.3902439,62.5,68.44512195,1,71,98
LAPCHJO01 ,1953,1,Joe,Lapchick,44,28,0,4,NYK,72,4,61.11111111,0,30.55555556,0,44,76
GOTTLED01 ,1953,1,Eddie,Gottlieb,29,43,0,0,PH1,72,0,40.27777778,#DIV/0!,#DIV/0!,#DIV/0!,29,72
HEINSTO01 ,1972,1,Tom,Heinsohn,68,14,7,6,BOS,82,13,82.92682927,53.84615385,68.38649156,1,75,95
HOLZMRE01 ,1969,1,Red,Holzman,60,22,12,7,NYK,82,19,73.17073171,63.15789474,68.16431322,1,72,101
TOMJARU01 ,1993,1,Rudy,Tomjanovich,58,24,15,8,HOU,82,23,70.73170732,65.2173913,67.97454931,1,73,105
HILLBO01  ,1994,1,Bob,Hill,62,20,9,6,SAS,82,15,75.6097561,60,67.80487805,1,71,97
HOLZMRE01 ,1954,1,Red,Holzman,26,46,0,0,MI1,72,0,36.11111111,#DIV/0!,#DIV/0!,#DIV/0!,26,72
BROWNLA01 ,2003,1,Larry,Brown,54,28,16,7,DET,82,23,65.85365854,69.56521739,67.70943796,1,70,105
BIRDLA01  ,1998,1,Larry,Bird,33,17,9,4,IND,50,13,66,69.23076923,67.61538462,1,42,63
GOTTLED01 ,1954,1,Eddie,Gottlieb,33,39,0,0,PH1,72,0,45.83333333,#DIV/0!,#DIV/0!,#DIV/0!,33,72
FITCHBI01 ,1981,1,Bill,Fitch,63,19,7,5,BOS,82,12,76.82926829,58.33333333,67.58130081,1,70,94
HEINSTO01 ,1973,1,Tom,Heinsohn,56,26,12,6,BOS,82,18,68.29268293,66.66666667,67.4796748,1,68,100
DUNLEMI01 ,1999,1,Mike,Dunleavy,59,23,10,6,POR,82,16,71.95121951,62.5,67.22560976,1,69,98
CERVIAL01 ,1949,1,Al,Cervi,51,13,6,5,SYR,64,11,79.6875,54.54545455,67.11647727,1,57,75
AUERBRE01 ,1962,1,Red,Auerbach,58,22,8,5,BOS,80,13,72.5,61.53846154,67.01923077,1,66,93
LAPCHJO01 ,1955,1,Joe,Lapchick,26,25,0,0,NYK,51,0,50.98039216,#DIV/0!,#DIV/0!,#DIV/0!,26,51
BORYLVI01 ,1955,1,Vince,Boryla,9,12,0,0,NYK,21,0,42.85714286,#DIV/0!,#DIV/0!,#DIV/0!,9,21
WILKELE01 ,1978,1,Lenny,Wilkens,52,30,12,5,SEA,82,17,63.41463415,70.58823529,67.00143472,1,64,99
WANZEBO01 ,1955,1,Bob,Wanzer,31,41,0,0,ROC,72,0,43.05555556,#DIV/0!,#DIV/0!,#DIV/0!,31,72
DUNLEMI01 ,1990,1,Mike,Dunleavy,58,24,12,7,LAL,82,19,70.73170732,63.15789474,66.94480103,1,70,101
RAMSAJA01 ,1976,1,Jack,Ramsay,49,33,14,5,POR,82,19,59.75609756,73.68421053,66.72015404,1,63,101
JEANNBU01 ,1947,1,Buddy,Jeannette,28,20,9,3,BA1,48,12,58.33333333,75,66.66666667,1,37,60
ECKMACH01 ,1956,1,Charles,Eckman,34,38,0,2,FTW,72,2,47.22222222,0,23.61111111,0,34,74
BIRDLA01  ,1997,1,Larry,Bird,58,24,10,6,IND,82,16,70.73170732,62.5,66.61585366,1,68,98
BORYLVI01 ,1956,1,Vince,Boryla,36,36,0,0,NYK,72,0,50,#DIV/0!,#DIV/0!,#DIV/0!,36,72
SENESGE01 ,1956,1,George,Senesky,37,35,0,2,PH1,72,2,51.38888889,0,25.69444444,0,37,74
WANZEBO01 ,1956,1,Bob,Wanzer,31,41,0,0,ROC,72,0,43.05555556,#DIV/0!,#DIV/0!,#DIV/0!,31,72
HOLZMRE01 ,1956,1,Red,Holzman,14,19,0,0,STL,33,0,42.42424242,#DIV/0!,#DIV/0!,#DIV/0!,14,33
MARTISL01 ,1956,2,Slater,Martin,5,3,0,0,STL,8,0,62.5,#DIV/0!,#DIV/0!,#DIV/0!,5,8
RILEYPA01 ,1992,1,Pat,Riley,60,22,9,6,NYK,82,15,73.17073171,60,66.58536585,1,69,97
CERVIAL01 ,1956,1,Al,Cervi,4,8,0,0,SYR,12,0,33.33333333,#DIV/0!,#DIV/0!,#DIV/0!,4,12
KUNDLJO01 ,1953,1,John,Kundla,46,26,9,4,MIE,72,13,63.88888889,69.23076923,66.55982906,1,55,85
ADELMRI01 ,1990,1,Rick,Adelman,63,19,9,7,POR,82,16,76.82926829,56.25,66.53963415,1,72,98
WANZEBO01 ,1957,1,Bob,Wanzer,33,39,0,2,CIN,72,2,45.83333333,0,22.91666667,0,33,74
ECKMACH01 ,1957,1,Charles,Eckman,9,16,0,0,DET,25,0,36,#DIV/0!,#DIV/0!,#DIV/0!,9,25
RILEYPA01 ,1985,1,Pat,Riley,62,20,8,6,LAL,82,14,75.6097561,57.14285714,66.37630662,1,70,96
MIKANGE01 ,1957,1,George,Mikan,9,30,0,0,MIE,39,0,23.07692308,#DIV/0!,#DIV/0!,#DIV/0!,9,39
KUNDLJO01 ,1957,2,John,Kundla,10,23,0,0,MIE,33,0,30.3030303,#DIV/0!,#DIV/0!,#DIV/0!,10,33
BORYLVI01 ,1957,1,Vince,Boryla,35,37,0,0,NYK,72,0,48.61111111,#DIV/0!,#DIV/0!,#DIV/0!,35,72
HEINSTO01 ,1975,1,Tom,Heinsohn,54,28,12,6,BOS,82,18,65.85365854,66.66666667,66.2601626,1,66,100
RILEYPA01 ,1983,1,Pat,Riley,54,28,14,7,LAL,82,21,65.85365854,66.66666667,66.2601626,1,68,103
SENESGE01 ,1955,1,George,Senesky,45,27,7,3,PH1,72,10,62.5,70,66.25,1,52,82
CUNNIBI01 ,1984,1,Billy,Cunningham,58,24,8,5,PHI,82,13,70.73170732,61.53846154,66.13508443,1,66,95
WANZEBO01 ,1958,1,Bob,Wanzer,3,15,0,0,CIN,18,0,16.66666667,#DIV/0!,#DIV/0!,#DIV/0!,3,18
MARSHTO01 ,1958,2,Tom,Marshall,16,38,0,0,CIN,54,0,29.62962963,#DIV/0!,#DIV/0!,#DIV/0!,16,54
AUERBRE01 ,1965,1,Red,Auerbach,54,26,11,6,BOS,80,17,67.5,64.70588235,66.10294118,1,65,97
AUERBRE01 ,1961,1,Red,Auerbach,60,20,8,6,BOS,80,14,75,57.14285714,66.07142857,1,68,94
LEVANAN01 ,1958,1,Andrew,Levane,40,32,0,2,NYK,72,2,55.55555556,0,27.77777778,0,40,74
CERVIAL01 ,1958,1,Al,Cervi,32,40,0,0,PH1,72,0,44.44444444,#DIV/0!,#DIV/0!,#DIV/0!,32,72
PHILLAN01 ,1958,1,Andy,Phillip,6,4,0,0,STL,10,0,60,#DIV/0!,#DIV/0!,#DIV/0!,6,10
WESTPPA01 ,1994,1,Paul,Westphal,59,23,6,4,PHO,82,10,71.95121951,60,65.97560976,1,65,92
CUNNIBI01 ,1980,1,Billy,Cunningham,62,20,9,7,PHI,82,16,75.6097561,56.25,65.92987805,1,71,98
HILLBR01  ,1995,1,Brian,Hill,60,22,7,5,ORL,82,12,73.17073171,58.33333333,65.75203252,1,67,94
MARSHTO01 ,1959,1,Tom,Marshall,19,56,0,0,CIN,75,0,25.33333333,#DIV/0!,#DIV/0!,#DIV/0!,19,75
ROCHAEP01 ,1959,1,Ephraim,Rocha,13,21,0,0,DET,34,0,38.23529412,#DIV/0!,#DIV/0!,#DIV/0!,13,34
MCGUIDI01 ,1959,2,Dick,McGuire,17,24,0,2,DET,41,2,41.46341463,0,20.73170732,0,17,43
CASTEJO01 ,1959,1,John,Castellani,11,25,0,0,MIE,36,0,30.55555556,#DIV/0!,#DIV/0!,#DIV/0!,11,36
ADELMRI01 ,1991,1,Rick,Adelman,57,25,13,8,POR,82,21,69.51219512,61.9047619,65.70847851,1,70,103
LEVANAN01 ,1959,1,Andrew,Levane,8,19,0,0,NYK,27,0,29.62962963,#DIV/0!,#DIV/0!,#DIV/0!,8,27
BRAUNCA01 ,1959,1,Carl,Braun,19,29,0,0,NYK,48,0,39.58333333,#DIV/0!,#DIV/0!,#DIV/0!,19,48
COSTELA01 ,1971,1,Larry,Costello,63,19,6,5,MIL,82,11,76.82926829,54.54545455,65.68736142,1,69,93
AUERBRE01 ,1956,1,Red,Auerbach,44,28,7,3,BOS,72,10,61.11111111,70,65.55555556,1,51,82
ADELMRI01 ,2002,1,Rick,Adelman,59,23,7,5,SAC,82,12,71.95121951,58.33333333,65.14227642,1,66,94
VANBRBI01 ,1967,1,Bill,VanBredaKolff,52,30,10,5,LAL,82,15,63.41463415,66.66666667,65.04065041,1,62,97
WOLFCH01  ,1960,1,Charles,Wolf,33,46,0,0,CIN,79,0,41.7721519,#DIV/0!,#DIV/0!,#DIV/0!,33,79
DALYCH01  ,1986,1,Chuck,Daly,52,30,10,5,DET,82,15,63.41463415,66.66666667,65.04065041,1,62,97
FITCHBI01 ,1979,1,Bill,Fitch,61,21,5,4,BOS,82,9,74.3902439,55.55555556,64.97289973,1,66,91
BRAUNCA01 ,1960,1,Carl,Braun,21,58,0,0,NYK,79,0,26.58227848,#DIV/0!,#DIV/0!,#DIV/0!,21,79
JOHNSNE01 ,1960,1,Neil,Johnston,46,33,0,3,PH1,79,3,58.2278481,0,29.11392405,0,46,82
KUNDLJO01 ,1951,1,John,Kundla,40,26,9,4,MIE,66,13,60.60606061,69.23076923,64.91841492,1,49,79
WESTPPA01 ,1992,1,Paul,Westphal,62,20,13,11,PHO,82,24,75.6097561,54.16666667,64.88821138,1,75,106
SCOTTBY01 ,2002,1,Byron,Scott,49,33,14,6,NJN,82,20,59.75609756,70,64.87804878,1,63,102
POLLAJI01 ,1961,1,Jim,Pollard,18,62,0,0,CH2,80,0,22.5,#DIV/0!,#DIV/0!,#DIV/0!,18,80
CUNNIBI01 ,1977,2,Billy,Cunningham,53,23,6,4,PHI,76,10,69.73684211,60,64.86842105,1,59,86
HANNUAL01 ,1957,1,Alex,Hannum,41,31,8,3,STL,72,11,56.94444444,72.72727273,64.83585859,1,49,83
JACKSPH01 ,1989,1,Phil,Jackson,55,27,10,6,CHI,82,16,67.07317073,62.5,64.78658537,1,65,98
DOVOVED01 ,1961,1,Eddie,Dovovan,29,51,0,0,NYK,80,0,36.25,#DIV/0!,#DIV/0!,#DIV/0!,29,80
VANGUJE01 ,1996,1,Jeff,Van Gundy,57,25,6,4,NYK,82,10,69.51219512,60,64.75609756,1,63,92
SEYMOPA01 ,1961,1,Paul,Seymour,5,9,0,0,STL,14,0,35.71428571,#DIV/0!,#DIV/0!,#DIV/0!,5,14
LEVANAN01 ,1961,2,Andrew,Levane,20,40,0,0,STL,60,0,33.33333333,#DIV/0!,#DIV/0!,#DIV/0!,20,60
PETTIBO01 ,1961,3,Bob,Pettit,4,2,0,0,STL,6,0,66.66666667,#DIV/0!,#DIV/0!,#DIV/0!,4,6
POPOVGR01 ,2003,1,Gregg,Popovich,57,25,6,4,SAS,82,10,69.51219512,60,64.75609756,1,63,92
HANNUAL01 ,1967,1,Alex,Hannum,62,20,7,6,PHI,82,13,75.6097561,53.84615385,64.72795497,1,69,95
MCMAHJA01 ,1962,1,Jack,McMahon,12,26,0,0,CH2,38,0,31.57894737,#DIV/0!,#DIV/0!,#DIV/0!,12,38
LEONABO01 ,1962,2,Bob,Leonard,13,29,0,0,CH2,42,0,30.95238095,#DIV/0!,#DIV/0!,#DIV/0!,13,42
ATTLEAL01 ,1974,1,Al,Attles,48,34,12,5,GSW,82,17,58.53658537,70.58823529,64.56241033,1,60,99
ADELMRI01 ,1989,1,Rick,Adelman,59,23,12,9,POR,82,21,71.95121951,57.14285714,64.54703833,1,71,103
WILKELE01 ,1977,2,Lenny,Wilkens,42,18,13,9,SEA,60,22,70,59.09090909,64.54545455,1,55,82
DOVOVED01 ,1962,1,Eddie,Dovovan,21,59,0,0,NYK,80,0,26.25,#DIV/0!,#DIV/0!,#DIV/0!,21,80
FEERIBO01 ,1962,1,Bob,Feerick,31,49,0,0,SFW,80,0,38.75,#DIV/0!,#DIV/0!,#DIV/0!,31,80
RUSSEBI01 ,1967,1,Bill,Russell,54,28,12,7,BOS,82,19,65.85365854,63.15789474,64.50577664,1,66,101
JONESKC01 ,1986,1,KC,Jones,59,23,13,10,BOS,82,23,71.95121951,56.52173913,64.23647932,1,72,105
LEONABO01 ,1963,1,Bob,Leonard,31,49,0,0,BAL,80,0,38.75,#DIV/0!,#DIV/0!,#DIV/0!,31,80
BROWNLA01 ,1989,1,Larry,Brown,56,26,6,4,SAS,82,10,68.29268293,60,64.14634146,1,62,92
WESTPPA01 ,1993,1,Paul,Westphal,56,26,6,4,PHO,82,10,68.29268293,60,64.14634146,1,62,92
WOLFCH01  ,1963,1,Charles,Wolf,23,57,0,0,DET,80,0,28.75,#DIV/0!,#DIV/0!,#DIV/0!,23,80
HARRIDE01 ,1997,1,Del,Harris,61,21,7,6,LAL,82,13,74.3902439,53.84615385,64.11819887,1,68,95
DOVOVED01 ,1963,1,Eddie,Dovovan,22,58,0,0,NYK,80,0,27.5,#DIV/0!,#DIV/0!,#DIV/0!,22,80
VANBRBI01 ,1968,1,Bill,VanBredaKolff,55,27,11,7,LAL,82,18,67.07317073,61.11111111,64.09214092,1,66,100
CUNNIBI01 ,1981,1,Billy,Cunningham,58,24,12,9,PHI,82,21,70.73170732,57.14285714,63.93728223,1,70,103
HEINSTO01 ,1974,1,Tom,Heinsohn,60,22,6,5,BOS,82,11,73.17073171,54.54545455,63.85809313,1,66,93
CERVIAL01 ,1953,1,Al,Cervi,42,30,9,4,SYR,72,13,58.33333333,69.23076923,63.78205128,1,51,85
JACKSPH01 ,2003,1,Phil,Jackson,56,26,13,9,LAL,82,22,68.29268293,59.09090909,63.69179601,1,69,104
FITCHBI01 ,1985,1,Bill,Fitch,51,31,13,7,HOU,82,20,62.19512195,65,63.59756098,1,64,102
WOLFCH01  ,1964,1,Charles,Wolf,2,9,0,0,DET,11,0,18.18181818,#DIV/0!,#DIV/0!,#DIV/0!,2,11
DEBUSDA01 ,1964,2,Dave,DeBusschere,29,40,0,0,DET,69,0,42.02898551,#DIV/0!,#DIV/0!,#DIV/0!,29,69
JACKSPH01 ,1993,1,Phil,Jackson,55,27,6,4,CHI,82,10,67.07317073,60,63.53658537,1,61,92
DOVOVED01 ,1964,1,Eddie,Dovovan,12,26,0,0,NYK,38,0,31.57894737,#DIV/0!,#DIV/0!,#DIV/0!,12,38
GALLAHA01 ,1964,2,Harry,Gallatin,19,23,0,0,NYK,42,0,45.23809524,#DIV/0!,#DIV/0!,#DIV/0!,19,42
DALYCH01  ,1987,1,Chuck,Daly,54,28,14,9,DET,82,23,65.85365854,60.86956522,63.36161188,1,68,105
HANNUAL01 ,1964,1,Alex,Hannum,17,63,0,0,SFW,80,0,21.25,#DIV/0!,#DIV/0!,#DIV/0!,17,80
GALLAHA01 ,1964,1,Harry,Gallatin,17,16,0,0,STL,33,0,51.51515152,#DIV/0!,#DIV/0!,#DIV/0!,17,33
SAUNDFL01 ,2003,1,Flip,Saunders,58,24,10,8,MIN,82,18,70.73170732,55.55555556,63.14363144,1,68,100
SEYMOPA01 ,1965,1,Paul,Seymour,38,42,0,3,BAL,80,3,47.5,0,23.75,0,38,83
FRANKLA01 ,2003,2,Larry,Frank,25,15,7,4,NJN,40,11,62.5,63.63636364,63.06818182,1,32,51
SHARMBI01 ,1972,1,Bill,Sharman,60,22,9,8,LAL,82,17,73.17073171,52.94117647,63.05595409,1,69,99
DEBUSDA01 ,1965,1,Dave,DeBusschere,22,58,0,0,DET,80,0,27.5,#DIV/0!,#DIV/0!,#DIV/0!,22,80
HOLZMRE01 ,1968,1,Red,Holzman,54,28,6,4,NYK,82,10,65.85365854,60,62.92682927,1,60,92
MCGUIDI01 ,1965,1,Dick,McGuire,24,35,0,0,NYK,59,0,40.6779661,#DIV/0!,#DIV/0!,#DIV/0!,24,59
GALLAHA01 ,1965,1,Harry,Gallatin,6,15,0,0,NYK,21,0,28.57142857,#DIV/0!,#DIV/0!,#DIV/0!,6,21
ATTLEAL01 ,1975,1,Al,Attles,59,23,7,6,GSW,82,13,71.95121951,53.84615385,62.89868668,1,66,95
HANNUAL01 ,1965,1,Alex,Hannum,35,45,0,0,SFW,80,0,43.75,#DIV/0!,#DIV/0!,#DIV/0!,35,80
TOMJARU01 ,1996,1,Rudy,Tomjanovich,57,25,9,7,HOU,82,16,69.51219512,56.25,62.88109756,1,66,98
FARMEMI01 ,1966,1,Mike,Farmer,1,8,0,0,BAL,9,0,11.11111111,#DIV/0!,#DIV/0!,#DIV/0!,1,9
JEANNBU01 ,1966,2,Buddy,Jeannette,3,13,0,0,BAL,16,0,18.75,#DIV/0!,#DIV/0!,#DIV/0!,3,16
SHUEGE01  ,1966,3,Gene,Shue,16,40,0,0,BAL,56,0,28.57142857,#DIV/0!,#DIV/0!,#DIV/0!,16,56
RILEYPA01 ,1993,1,Pat,Riley,57,25,14,11,NYK,82,25,69.51219512,56,62.75609756,1,71,107
KERRJO01  ,1966,1,John,Kerr,33,48,0,3,CHI,81,3,40.74074074,0,20.37037037,0,33,84
TOMJARU01 ,1994,1,Rudy,Tomjanovich,47,35,15,7,HOU,82,22,57.31707317,68.18181818,62.74944568,1,62,104
DEBUSDA01 ,1966,1,Dave,DeBusschere,28,45,0,0,DET,73,0,38.35616438,#DIV/0!,#DIV/0!,#DIV/0!,28,73
BUTCHDO01 ,1966,2,Donnis,Butcher,2,9,0,0,DET,11,0,18.18181818,#DIV/0!,#DIV/0!,#DIV/0!,2,11
SCHAUFR01 ,1966,1,Fred,Schaus,36,45,0,3,LAL,81,3,44.44444444,0,22.22222222,0,36,84
FITZSCO01 ,1988,1,Cotton,Fitzsimmons,55,27,7,5,PHO,82,12,67.07317073,58.33333333,62.70325203,1,62,94
ADELMRI01 ,2003,1,Rick,Adelman,55,27,7,5,SAC,82,12,67.07317073,58.33333333,62.70325203,1,62,94
RUSSEBI01 ,1968,1,Bill,Russell,48,34,12,6,BOS,82,18,58.53658537,66.66666667,62.60162602,1,60,100
HARRILE01 ,1948,1,Les,Harrison,45,15,2,2,ROC,60,4,75,50,62.5,1,47,64
SHUEGE01  ,1967,1,Gene,Shue,36,46,0,0,BAL,82,0,43.90243902,#DIV/0!,#DIV/0!,#DIV/0!,36,82
BIRDLA01  ,1999,1,Larry,Bird,56,26,13,10,IND,82,23,68.29268293,56.52173913,62.40721103,1,69,105
HARRILE01 ,1950,1,Les,Harrison,41,27,9,5,ROC,68,14,60.29411765,64.28571429,62.28991597,1,50,82
JUCKEED01 ,1967,1,Ed,Jucker,39,43,0,0,CIN,82,0,47.56097561,#DIV/0!,#DIV/0!,#DIV/0!,39,82
POPOVGR01 ,2000,1,Gregg,Popovich,58,24,7,6,SAS,82,13,70.73170732,53.84615385,62.28893058,1,65,95
RILEYPA01 ,1982,1,Pat,Riley,58,24,8,7,LAL,82,15,70.73170732,53.33333333,62.03252033,1,66,97
MCGUIDI01 ,1967,1,Dick,McGuire,15,22,0,0,NYK,37,0,40.54054054,#DIV/0!,#DIV/0!,#DIV/0!,15,37
DUNLEMI01 ,1998,1,Mike,Dunleavy,35,15,7,6,POR,50,13,70,53.84615385,61.92307692,1,42,63
ADUBARI01 ,1996,2,Richie,Adubato,21,12,3,2,ORL,33,5,63.63636364,60,61.81818182,1,24,38
MCMAHJA01 ,1967,1,Jack,McMahon,15,67,0,0,SDR,82,0,18.29268293,#DIV/0!,#DIV/0!,#DIV/0!,15,82
BIANCAL01 ,1967,1,Al,Bianchi,23,59,0,0,SEA,82,0,28.04878049,#DIV/0!,#DIV/0!,#DIV/0!,23,82
MACLEJO01 ,1987,1,John,MacLeod,53,29,10,7,DAL,82,17,64.63414634,58.82352941,61.72883788,1,63,99
RILEYPA01 ,1999,1,Pat,Riley,52,30,6,4,MIA,82,10,63.41463415,60,61.70731707,1,58,92
CERVIAL01 ,1954,1,Al,Cervi,43,29,7,4,SYR,72,11,59.72222222,63.63636364,61.67929293,1,50,83
SHUEGE01  ,1968,1,Gene,Shue,57,25,0,4,BAL,82,4,69.51219512,0,34.75609756,0,57,86
SLOANJE01 ,1991,1,Jerry,Sloan,55,27,9,7,UTA,82,16,67.07317073,56.25,61.66158537,1,64,98
MOTTADI01 ,1968,1,Dick,Motta,33,49,0,0,CHI,82,0,40.24390244,#DIV/0!,#DIV/0!,#DIV/0!,33,82
JUCKEED01 ,1968,1,Ed,Jucker,41,41,0,0,CIN,82,0,50,#DIV/0!,#DIV/0!,#DIV/0!,41,82
BUTCHDO01 ,1968,1,Donnis,Butcher,10,12,0,0,DET,22,0,45.45454545,#DIV/0!,#DIV/0!,#DIV/0!,10,22
SEYMOPA01 ,1968,2,Paul,Seymour,22,38,0,0,DET,60,0,36.66666667,#DIV/0!,#DIV/0!,#DIV/0!,22,60
NELSODO01 ,2002,1,Don,Nelson,60,22,10,10,DAL,82,20,73.17073171,50,61.58536585,1,70,102
COSTELA01 ,1968,1,Larry,Costello,27,55,0,0,MIL,82,0,32.92682927,#DIV/0!,#DIV/0!,#DIV/0!,27,82
SLOANJE01 ,1995,1,Jerry,Sloan,55,27,10,8,UTA,82,18,67.07317073,55.55555556,61.31436314,1,65,100
AUERBRE01 ,1957,1,Red,Auerbach,49,23,6,5,BOS,72,11,68.05555556,54.54545455,61.30050505,1,55,83
KERRJO01  ,1968,1,John,Kerr,16,66,0,0,PHO,82,0,19.51219512,#DIV/0!,#DIV/0!,#DIV/0!,16,82
JONESKC01 ,1987,1,KC,Jones,57,25,9,8,BOS,82,17,69.51219512,52.94117647,61.2266858,1,66,99
BIANCAL01 ,1968,1,Al,Bianchi,30,52,0,0,SEA,82,0,36.58536585,#DIV/0!,#DIV/0!,#DIV/0!,30,82
WILKELE01 ,1991,1,Lenny,Wilkens,57,25,9,8,CLE,82,17,69.51219512,52.94117647,61.2266858,1,66,99
BROWNLA01 ,1994,1,Larry,Brown,52,30,10,7,IND,82,17,63.41463415,58.82352941,61.11908178,1,62,99
FITZSCO01 ,1989,1,Cotton,Fitzsimmons,54,28,9,7,PHO,82,16,65.85365854,56.25,61.05182927,1,63,98
HEINSTO01 ,1969,1,Tom,Heinsohn,34,48,0,0,BOS,82,0,41.46341463,#DIV/0!,#DIV/0!,#DIV/0!,34,82
HILLBO01  ,1995,1,Bob,Hill,59,23,5,5,SAS,82,10,71.95121951,50,60.97560976,1,64,92
COUSYBO01 ,1969,1,Bob,Cousy,36,46,0,0,CIN,82,0,43.90243902,#DIV/0!,#DIV/0!,#DIV/0!,36,82
VANBRBI01 ,1969,1,Bill,VanBredaKolff,31,51,0,0,DET,82,0,37.80487805,#DIV/0!,#DIV/0!,#DIV/0!,31,82
HILLBR01  ,1994,1,Brian,Hill,57,25,11,10,ORL,82,21,69.51219512,52.38095238,60.94657375,1,68,103
HOLZMRE01 ,1970,1,Red,Holzman,52,30,7,5,NYK,82,12,63.41463415,58.33333333,60.87398374,1,59,94
LAPCHJO01 ,1952,1,Joe,Lapchick,47,23,6,5,NYK,70,11,67.14285714,54.54545455,60.84415584,1,53,81
RILEYPA01 ,1994,1,Pat,Riley,55,27,6,5,NYK,82,11,67.07317073,54.54545455,60.80931264,1,61,93
KERRJO01  ,1969,1,John,Kerr,15,23,0,0,PHO,38,0,39.47368421,#DIV/0!,#DIV/0!,#DIV/0!,15,38
RILEYPA01 ,1996,1,Pat,Riley,61,21,8,9,MIA,82,17,74.3902439,47.05882353,60.72453372,1,69,99
MCMAHJA01 ,1969,1,Jack,McMahon,9,17,0,0,SDR,26,0,34.61538462,#DIV/0!,#DIV/0!,#DIV/0!,9,26
HANNUAL01 ,1969,2,Alex,Hannum,18,38,0,0,SDR,56,0,32.14285714,#DIV/0!,#DIV/0!,#DIV/0!,18,56
WILKELE01 ,1969,1,Lenny,Wilkens,36,46,0,0,SEA,82,0,43.90243902,#DIV/0!,#DIV/0!,#DIV/0!,36,82
LEEGE01   ,1969,1,George,Lee,22,30,0,0,SFW,52,0,42.30769231,#DIV/0!,#DIV/0!,#DIV/0!,22,52
ATTLEAL01 ,1969,2,Al,Attles,8,22,0,0,SFW,30,0,26.66666667,#DIV/0!,#DIV/0!,#DIV/0!,8,30
SCHAUFR01 ,1961,1,Fred,Schaus,54,26,7,6,LAL,80,13,67.5,53.84615385,60.67307692,1,61,93
RILEYPA01 ,1989,1,Pat,Riley,63,19,4,5,LAL,82,9,76.82926829,44.44444444,60.63685637,1,67,91
HEINSTO01 ,1970,1,Tom,Heinsohn,44,38,0,0,BOS,82,0,53.65853659,#DIV/0!,#DIV/0!,#DIV/0!,44,82
SCHAYDO01 ,1970,1,Dolph,Schayes,22,60,0,0,BUF,82,0,26.82926829,#DIV/0!,#DIV/0!,#DIV/0!,22,82
MACLEJO01 ,1978,1,John,MacLeod,50,32,9,6,PHO,82,15,60.97560976,60,60.48780488,1,59,97
COUSYBO01 ,1970,1,Bob,Cousy,33,49,0,0,CIN,82,0,40.24390244,#DIV/0!,#DIV/0!,#DIV/0!,33,82
FITCHBI01 ,1970,1,Bill,Fitch,15,67,0,0,CLE,82,0,18.29268293,#DIV/0!,#DIV/0!,#DIV/0!,15,82
VANBRBI01 ,1970,1,Bill,VanBredaKolff,45,37,0,0,DET,82,0,54.87804878,#DIV/0!,#DIV/0!,#DIV/0!,45,82
BROWNLA01 ,2000,1,Larry,Brown,56,26,12,11,PHI,82,23,68.29268293,52.17391304,60.23329799,1,68,105
MOTTADI01 ,1977,1,Dick,Motta,44,38,14,7,WA1,82,21,53.65853659,66.66666667,60.16260163,1,58,103
JONESKC01 ,1974,1,KC,Jones,60,22,8,9,WA1,82,17,73.17073171,47.05882353,60.11477762,1,68,99
BROWNLA01 ,1993,1,Larry,Brown,47,35,10,6,IND,82,16,57.31707317,62.5,59.90853659,1,57,98
FITZSCO01 ,1970,1,Cotton,Fitzsimmons,48,34,0,0,PHO,82,0,58.53658537,#DIV/0!,#DIV/0!,#DIV/0!,48,82
TODDRO01  ,1970,1,Rolland,Todd,29,53,0,0,POR,82,0,35.36585366,#DIV/0!,#DIV/0!,#DIV/0!,29,82
WINTETE01 ,1970,1,Tex,Winter,40,42,0,0,SDR,82,0,48.7804878,#DIV/0!,#DIV/0!,#DIV/0!,40,82
WILKELE01 ,1970,1,Lenny,Wilkens,38,44,0,0,SEA,82,0,46.34146341,#DIV/0!,#DIV/0!,#DIV/0!,38,82
KARLGE01  ,1992,1,George,Karl,55,27,10,9,SEA,82,19,67.07317073,52.63157895,59.85237484,1,65,101
KARLGE01  ,1996,1,George,Karl,57,25,6,6,SEA,82,12,69.51219512,50,59.75609756,1,63,94
NELSODO01 ,2001,1,Don,Nelson,57,25,4,4,DAL,82,8,69.51219512,50,59.75609756,1,61,90
NELSODO01 ,1985,1,Don,Nelson,57,25,7,7,MIL,82,14,69.51219512,50,59.75609756,1,64,96
SCHAYDO01 ,1971,1,Dolph,Schayes,0,1,0,0,BUF,1,0,0,#DIV/0!,#DIV/0!,#DIV/0!,0,1
MCCARJO01 ,1971,2,John,McCarthy,22,59,0,0,BUF,81,0,27.16049383,#DIV/0!,#DIV/0!,#DIV/0!,22,81
MOTTADI01 ,1971,1,Dick,Motta,57,25,0,4,CHI,82,4,69.51219512,0,34.75609756,0,57,86
COUSYBO01 ,1971,1,Bob,Cousy,30,52,0,0,CIN,82,0,36.58536585,#DIV/0!,#DIV/0!,#DIV/0!,30,82
FITCHBI01 ,1971,1,Bill,Fitch,23,59,0,0,CLE,82,0,28.04878049,#DIV/0!,#DIV/0!,#DIV/0!,23,82
VANBRBI01 ,1971,1,Bill,VanBredaKolff,6,6,0,0,DET,12,0,50,#DIV/0!,#DIV/0!,#DIV/0!,6,12
LLOYDEA01 ,1971,2,Earl,Lloyd,20,50,0,0,DET,70,0,28.57142857,#DIV/0!,#DIV/0!,#DIV/0!,20,70
SLOANJE01 ,1998,1,Jerry,Sloan,37,13,5,6,UTA,50,11,74,45.45454545,59.72727273,1,42,61
WINTETE01 ,1971,1,Tex,Winter,34,48,0,0,HOU,82,0,41.46341463,#DIV/0!,#DIV/0!,#DIV/0!,34,82
ALBECST01 ,1982,1,Stan,Albeck,53,29,6,5,SAS,82,11,64.63414634,54.54545455,59.58980044,1,59,93
PITINRI01 ,1988,1,Rick,Pitino,52,30,5,4,NYK,82,9,63.41463415,55.55555556,59.48509485,1,57,91
KARLGE01  ,2000,1,George,Karl,52,30,10,8,MIL,82,18,63.41463415,55.55555556,59.48509485,1,62,100
RAMSAJA01 ,1971,1,Jack,Ramsay,30,52,0,0,PHI,82,0,36.58536585,#DIV/0!,#DIV/0!,#DIV/0!,30,82
FITZSCO01 ,1971,1,Cotton,Fitzsimmons,49,33,0,0,PHO,82,0,59.75609756,#DIV/0!,#DIV/0!,#DIV/0!,49,82
TODDRO01  ,1971,1,Rolland,Todd,12,44,0,0,POR,56,0,21.42857143,#DIV/0!,#DIV/0!,#DIV/0!,12,56
INMANST01 ,1971,2,Stu,Inman,6,20,0,0,POR,26,0,23.07692308,#DIV/0!,#DIV/0!,#DIV/0!,6,26
WILKELE01 ,1971,1,Lenny,Wilkens,47,35,0,0,SEA,82,0,57.31707317,#DIV/0!,#DIV/0!,#DIV/0!,47,82
LAPCHJO01 ,1949,1,Joe,Lapchick,40,28,3,2,NYK,68,5,58.82352941,60,59.41176471,1,43,73
RUSSEBI01 ,1966,1,Bill,Russell,60,21,4,5,BOS,81,9,74.07407407,44.44444444,59.25925926,1,64,90
SCOTTBY01 ,2001,1,Byron,Scott,52,30,11,9,NJN,82,20,63.41463415,55,59.20731707,1,63,102
RAMSAJA01 ,1972,1,Jack,Ramsay,21,61,0,0,BUF,82,0,25.6097561,#DIV/0!,#DIV/0!,#DIV/0!,21,82
COSTELA01 ,1969,1,Larry,Costello,56,26,5,5,MIL,82,10,68.29268293,50,59.14634146,1,61,92
FITCHBI01 ,1972,1,Bill,Fitch,32,50,0,0,CLE,82,0,39.02439024,#DIV/0!,#DIV/0!,#DIV/0!,32,82
LLOYDEA01 ,1972,1,Earl,Lloyd,2,5,0,0,DET,7,0,28.57142857,#DIV/0!,#DIV/0!,#DIV/0!,2,7
SCOTTRA01 ,1972,2,Ray,Scott,38,37,0,0,DET,75,0,50.66666667,#DIV/0!,#DIV/0!,#DIV/0!,38,75
FORDCH01  ,1990,1,Chris,Ford,56,26,5,5,BOS,82,10,68.29268293,50,59.14634146,1,61,92
WINTETE01 ,1972,1,Tex,Winter,17,30,0,0,HOU,47,0,36.17021277,#DIV/0!,#DIV/0!,#DIV/0!,17,47
EGANJO01  ,1972,2,John,Egan,16,19,0,0,HOU,35,0,45.71428571,#DIV/0!,#DIV/0!,#DIV/0!,16,35
COUSYBO01 ,1972,1,Bob,Cousy,36,46,0,0,KCK,82,0,43.90243902,#DIV/0!,#DIV/0!,#DIV/0!,36,82
AUERBRE01 ,1948,1,Red,Auerbach,38,22,6,5,WSC,60,11,63.33333333,54.54545455,58.93939394,1,44,71
NELSODO01 ,1982,1,Don,Nelson,51,31,5,4,MIL,82,9,62.19512195,55.55555556,58.87533875,1,56,91
VANGUJE01 ,1999,1,Jeff,Van Gundy,50,32,9,7,NYK,82,16,60.97560976,56.25,58.61280488,1,59,98
RUBINRO01 ,1972,1,Roy,Rubin,4,47,0,0,PHI,51,0,7.843137255,#DIV/0!,#DIV/0!,#DIV/0!,4,51
LOUGHKE01 ,1972,2,Kevin,Loughery,5,26,0,0,PHI,31,0,16.12903226,#DIV/0!,#DIV/0!,#DIV/0!,5,31
VANBRBI01 ,1972,1,Bill,VanBredaKolff,3,5,0,0,PHO,8,0,37.5,#DIV/0!,#DIV/0!,#DIV/0!,3,8
COLANJE01 ,1972,2,Jerry,Colangelo,35,39,0,0,PHO,74,0,47.2972973,#DIV/0!,#DIV/0!,#DIV/0!,35,74
MCCLOJA01 ,1972,1,Jack,McCloskey,21,61,0,0,POR,82,0,25.6097561,#DIV/0!,#DIV/0!,#DIV/0!,21,82
NISSATO01 ,1972,1,Tom,Nissalke,13,32,0,0,SEA,45,0,28.88888889,#DIV/0!,#DIV/0!,#DIV/0!,13,45
BUCKWBU01 ,1972,2,Bucky,Buckwalter,13,24,0,0,SEA,37,0,35.13513514,#DIV/0!,#DIV/0!,#DIV/0!,13,37
FITZSCO01 ,1973,1,Cotton,Fitzsimmons,35,47,0,0,ATL,82,0,42.68292683,#DIV/0!,#DIV/0!,#DIV/0!,35,82
MULLAJO01 ,1969,1,Joe,Mullaney,46,36,11,7,LAL,82,18,56.09756098,61.11111111,58.60433604,1,57,100
TOMJARU01 ,1992,1,Rudy,Tomjanovich,55,27,6,6,HOU,82,12,67.07317073,50,58.53658537,1,61,94
KARLGE01  ,1993,1,George,Karl,63,19,2,3,SEA,82,5,76.82926829,40,58.41463415,1,65,87
MOEDO01   ,1984,1,Doug,Moe,52,30,8,7,DEN,82,15,63.41463415,53.33333333,58.37398374,1,60,97
FITCHBI01 ,1973,1,Bill,Fitch,29,53,0,0,CLE,82,0,35.36585366,#DIV/0!,#DIV/0!,#DIV/0!,29,82
FORDCH01  ,1991,1,Chris,Ford,51,31,6,5,BOS,82,11,62.19512195,54.54545455,58.37028825,1,57,93
ATTLEAL01 ,1973,1,Al,Attles,44,38,0,0,GSW,82,0,53.65853659,#DIV/0!,#DIV/0!,#DIV/0!,44,82
EGANJO01  ,1973,1,John,Egan,32,50,0,0,HOU,82,0,39.02439024,#DIV/0!,#DIV/0!,#DIV/0!,32,82
COUSYBO01 ,1973,1,Bob,Cousy,6,16,0,0,KCK,22,0,27.27272727,#DIV/0!,#DIV/0!,#DIV/0!,6,22
YOUNGDR01 ,1973,2,Draff,Young,0,3,0,0,KCK,3,0,0,#DIV/0!,#DIV/0!,#DIV/0!,0,3
JOHNSPH01 ,1973,3,Phil,Johnson,27,30,0,0,KCK,57,0,47.36842105,#DIV/0!,#DIV/0!,#DIV/0!,27,57
SILASPA01 ,2000,1,Paul,Silas,46,36,6,4,CHA,82,10,56.09756098,60,58.04878049,1,52,92
NELSODO01 ,1980,1,Don,Nelson,60,22,3,4,MIL,82,7,73.17073171,42.85714286,58.01393728,1,63,89
OBRIEJI01 ,2001,1,Jim,O'Brien,49,33,9,7,BOS,82,16,59.75609756,56.25,58.00304878,1,58,98
SHUEGE01  ,1973,1,Gene,Shue,25,57,0,0,PHI,82,0,30.48780488,#DIV/0!,#DIV/0!,#DIV/0!,25,82
MACLEJO01 ,1973,1,John,MacLeod,30,52,0,0,PHO,82,0,36.58536585,#DIV/0!,#DIV/0!,#DIV/0!,30,82
MCCLOJA01 ,1973,1,Jack,McCloskey,27,55,0,0,POR,82,0,32.92682927,#DIV/0!,#DIV/0!,#DIV/0!,27,82
RUSSEBI01 ,1973,1,Bill,Russell,36,46,0,0,SEA,82,0,43.90243902,#DIV/0!,#DIV/0!,#DIV/0!,36,82
FITZSCO01 ,1974,1,Cotton,Fitzsimmons,31,51,0,0,ATL,82,0,37.80487805,#DIV/0!,#DIV/0!,#DIV/0!,31,82
GUOKAMA01 ,1985,1,Matt,Guokas,54,28,6,6,PHI,82,12,65.85365854,50,57.92682927,1,60,94
AUERBRE01 ,1946,1,Red,Auerbach,49,11,2,4,WSC,60,6,81.66666667,33.33333333,57.5,1,51,66
WILKELE01 ,1993,1,Lenny,Wilkens,57,25,5,6,ATL,82,11,69.51219512,45.45454545,57.48337029,1,62,93
FITCHBI01 ,1974,1,Bill,Fitch,40,42,0,0,CLE,82,0,48.7804878,#DIV/0!,#DIV/0!,#DIV/0!,40,82
WILKELE01 ,1979,1,Lenny,Wilkens,56,26,7,8,SEA,82,15,68.29268293,46.66666667,57.4796748,1,63,97
AUERBRE01 ,1952,1,Red,Auerbach,46,25,3,3,BOS,71,6,64.78873239,50,57.3943662,1,49,77
HOLZMRE01 ,1971,1,Red,Holzman,48,34,9,7,NYK,82,16,58.53658537,56.25,57.39329268,1,57,98
FITZSCO01 ,1991,1,Cotton,Fitzsimmons,53,29,4,4,PHO,82,8,64.63414634,50,57.31707317,1,57,90
SHARMBI01 ,1974,1,Bill,Sharman,30,52,0,0,LAL,82,0,36.58536585,#DIV/0!,#DIV/0!,#DIV/0!,30,82
COSTELA01 ,1974,1,Larry,Costello,38,44,0,0,MIL,82,0,46.34146341,#DIV/0!,#DIV/0!,#DIV/0!,38,82
ROBERSC01 ,1974,1,Scotty,Robertson,1,14,0,0,NOJ,15,0,6.666666667,#DIV/0!,#DIV/0!,#DIV/0!,1,15
BAYLOEL01 ,1974,2,Elgin,Baylor,0,1,0,0,NOJ,1,0,0,#DIV/0!,#DIV/0!,#DIV/0!,0,1
VANBRBI01 ,1974,3,Bill,VanBredaKolff,22,44,0,0,NOJ,66,0,33.33333333,#DIV/0!,#DIV/0!,#DIV/0!,22,66
SLOANJE01 ,1993,1,Jerry,Sloan,53,29,8,8,UTA,82,16,64.63414634,50,57.31707317,1,61,98
SHUEGE01  ,1974,1,Gene,Shue,34,48,0,0,PHI,82,0,41.46341463,#DIV/0!,#DIV/0!,#DIV/0!,34,82
MACLEJO01 ,1974,1,John,MacLeod,32,50,0,0,PHO,82,0,39.02439024,#DIV/0!,#DIV/0!,#DIV/0!,32,82
WILKELE01 ,1974,1,Lenny,Wilkens,38,44,0,0,POR,82,0,46.34146341,#DIV/0!,#DIV/0!,#DIV/0!,38,82
GALLAHA01 ,1962,1,Harry,Gallatin,48,32,6,5,STL,80,11,60,54.54545455,57.27272727,1,54,91
LUCASJO01 ,1992,2,John,Lucas,40,22,5,5,SAS,62,10,64.51612903,50,57.25806452,1,45,72
FITZSCO01 ,1975,1,Cotton,Fitzsimmons,28,46,0,0,ATL,74,0,37.83783784,#DIV/0!,#DIV/0!,#DIV/0!,28,74
TORMOGE01 ,1975,2,Gene,Tormohlen,1,7,0,0,ATL,8,0,12.5,#DIV/0!,#DIV/0!,#DIV/0!,1,8
KARLGE01  ,1997,1,George,Karl,61,21,4,6,SEA,82,10,74.3902439,40,57.19512195,1,65,92
SHARMBI01 ,1966,1,Bill,Sharman,44,37,9,6,SFW,81,15,54.32098765,60,57.16049383,1,53,96
MOTTADI01 ,1975,1,Dick,Motta,24,58,0,0,CHI,82,0,29.26829268,#DIV/0!,#DIV/0!,#DIV/0!,24,82
ECKMACH01 ,1954,1,Charles,Eckman,43,29,6,5,FTW,72,11,59.72222222,54.54545455,57.13383838,1,49,83
SCOTTRA01 ,1975,1,Ray,Scott,17,25,0,0,DET,42,0,40.47619048,#DIV/0!,#DIV/0!,#DIV/0!,17,42
VANGUJE01 ,1998,1,Jeff,Van Gundy,27,23,12,8,NYK,50,20,54,60,57,1,39,70
FRATEMI01 ,1986,1,Mike,Fratello,57,25,4,5,ATL,82,9,69.51219512,44.44444444,56.97831978,1,61,91
EGANJO01  ,1975,1,John,Egan,40,42,0,0,HOU,82,0,48.7804878,#DIV/0!,#DIV/0!,#DIV/0!,40,82
JOHNSPH01 ,1975,1,Phil,Johnson,31,51,0,0,KCK,82,0,37.80487805,#DIV/0!,#DIV/0!,#DIV/0!,31,82
SHARMBI01 ,1975,1,Bill,Sharman,40,42,0,0,LAL,82,0,48.7804878,#DIV/0!,#DIV/0!,#DIV/0!,40,82
HEINSTO01 ,1971,1,Tom,Heinsohn,56,26,5,6,BOS,82,11,68.29268293,45.45454545,56.87361419,1,61,93
VANBRBI01 ,1975,1,Bill,VanBredaKolff,38,44,0,0,NOJ,82,0,46.34146341,#DIV/0!,#DIV/0!,#DIV/0!,38,82
HOLZMRE01 ,1975,1,Red,Holzman,38,44,0,0,NYK,82,0,46.34146341,#DIV/0!,#DIV/0!,#DIV/0!,38,82
SHUEGE01  ,1976,1,Gene,Shue,50,32,10,9,PHI,82,19,60.97560976,52.63157895,56.80359435,1,60,101
MOTTADI01 ,1978,1,Dick,Motta,54,28,9,10,WA1,82,19,65.85365854,47.36842105,56.61103979,1,63,101
WILKELE01 ,1975,1,Lenny,Wilkens,37,45,0,0,POR,82,0,45.12195122,#DIV/0!,#DIV/0!,#DIV/0!,37,82
LAPCHJO01 ,1951,1,Joe,Lapchick,37,29,8,6,NYK,66,14,56.06060606,57.14285714,56.6017316,1,45,80
SLOANJE01 ,1994,1,Jerry,Sloan,60,22,2,3,UTA,82,5,73.17073171,40,56.58536585,1,62,87
BROWNHU01 ,1976,1,Hubie,Brown,31,51,0,0,ATL,82,0,37.80487805,#DIV/0!,#DIV/0!,#DIV/0!,31,82
CUNNIBI01 ,1978,1,Billy,Cunningham,47,35,5,4,PHI,82,9,57.31707317,55.55555556,56.43631436,1,52,91
LOCKETA01 ,1976,1,Tates,Locke,6,30,0,0,BUF,36,0,16.66666667,#DIV/0!,#DIV/0!,#DIV/0!,6,36
MACKIBO01 ,1976,2,Bob,MacKinnon,3,4,0,0,BUF,7,0,42.85714286,#DIV/0!,#DIV/0!,#DIV/0!,3,7
MULLAJO01 ,1976,3,Joe,Mullaney,11,18,0,0,BUF,29,0,37.93103448,#DIV/0!,#DIV/0!,#DIV/0!,11,29
WILKELE01 ,1996,1,Lenny,Wilkens,56,26,4,5,ATL,82,9,68.29268293,44.44444444,56.36856369,1,60,91
HARRIDE01 ,1996,1,Del,Harris,56,26,4,5,LAL,82,9,68.29268293,44.44444444,56.36856369,1,60,91
POPOVGR01 ,1997,1,Gregg,Popovich,56,26,4,5,SAS,82,9,68.29268293,44.44444444,56.36856369,1,60,91
SCHAUFR01 ,1962,1,Fred,Schaus,53,27,6,7,LAL,80,13,66.25,46.15384615,56.20192308,1,59,93
MACLEJO01 ,1980,1,John,MacLeod,57,25,3,4,PHO,82,7,69.51219512,42.85714286,56.18466899,1,60,89
RILEYPA01 ,1991,1,Pat,Riley,51,31,6,6,NYK,82,12,62.19512195,50,56.09756098,1,57,94
LEONABO01 ,1976,1,Bob,Leonard,36,46,0,0,IND,82,0,43.90243902,#DIV/0!,#DIV/0!,#DIV/0!,36,82
JOHNSPH01 ,1976,1,Phil,Johnson,40,42,0,0,KCK,82,0,48.7804878,#DIV/0!,#DIV/0!,#DIV/0!,40,82
HARRILE01 ,1951,1,Les,Harrison,41,25,3,3,ROC,66,6,62.12121212,50,56.06060606,1,44,72
COSTELA01 ,1976,1,Larry,Costello,3,15,0,0,MIL,18,0,16.66666667,#DIV/0!,#DIV/0!,#DIV/0!,3,18
NELSODO01 ,1976,2,Don,Nelson,27,37,0,0,MIL,64,0,42.1875,#DIV/0!,#DIV/0!,#DIV/0!,27,64
VANBRBI01 ,1976,1,Bill,VanBredaKolff,14,12,0,0,NOJ,26,0,53.84615385,#DIV/0!,#DIV/0!,#DIV/0!,14,26
BAYLOEL01 ,1976,2,Elgin,Baylor,21,35,0,0,NOJ,56,0,37.5,#DIV/0!,#DIV/0!,#DIV/0!,21,56
HOLZMRE01 ,1976,1,Red,Holzman,40,42,0,0,NYK,82,0,48.7804878,#DIV/0!,#DIV/0!,#DIV/0!,40,82
LOUGHKE01 ,1976,1,Kevin,Loughery,22,60,0,0,NYN,82,0,26.82926829,#DIV/0!,#DIV/0!,#DIV/0!,22,82
LAYDEFR01 ,1987,1,Frank,Layden,47,35,6,5,UTA,82,11,57.31707317,54.54545455,55.93126386,1,53,93
MACLEJO01 ,1976,1,John,MacLeod,34,48,0,0,PHO,82,0,41.46341463,#DIV/0!,#DIV/0!,#DIV/0!,34,82
LAPCHJO01 ,1950,1,Joe,Lapchick,36,30,8,6,NYK,66,14,54.54545455,57.14285714,55.84415584,1,44,80
MOEDO01   ,1976,1,Doug,Moe,44,38,0,2,SAS,82,2,53.65853659,0,26.82926829,0,44,84
RUSSEBI01 ,1976,1,Bill,Russell,40,42,0,0,SEA,82,0,48.7804878,#DIV/0!,#DIV/0!,#DIV/0!,40,82
BROWNHU01 ,1978,1,Hubie,Brown,46,36,5,4,ATL,82,9,56.09756098,55.55555556,55.82655827,1,51,91
BROWNHU01 ,1977,1,Hubie,Brown,41,41,0,2,ATL,82,2,50,0,25,0,41,84
HEINSTO01 ,1977,1,Tom,Heinsohn,11,23,0,0,BOS,34,0,32.35294118,#DIV/0!,#DIV/0!,#DIV/0!,11,34
SANDETO01 ,1977,2,Tom,Sanders,21,27,0,0,BOS,48,0,43.75,#DIV/0!,#DIV/0!,#DIV/0!,21,48
FITZSCO01 ,1977,1,Cotton,Fitzsimmons,27,55,0,0,BUF,82,0,32.92682927,#DIV/0!,#DIV/0!,#DIV/0!,27,82
BADGEED01 ,1977,1,Ed,Badger,40,42,0,0,CHI,82,0,48.7804878,#DIV/0!,#DIV/0!,#DIV/0!,40,82
FITCHBI01 ,1977,1,Bill,Fitch,43,39,0,2,CLE,82,2,52.43902439,0,26.2195122,0,43,84
DALYCH01  ,1984,1,Chuck,Daly,46,36,5,4,DET,82,9,56.09756098,55.55555556,55.82655827,1,51,91
BROWNHE01 ,1977,1,Herb,Brown,9,15,0,0,DET,24,0,37.5,#DIV/0!,#DIV/0!,#DIV/0!,9,24
KAUFFBO01 ,1977,2,Bob,Kauffman,29,29,0,0,DET,58,0,50,#DIV/0!,#DIV/0!,#DIV/0!,29,58
ATTLEAL01 ,1977,1,Al,Attles,43,39,0,0,GSW,82,0,52.43902439,#DIV/0!,#DIV/0!,#DIV/0!,43,82
NISSATO01 ,1977,1,Tom,Nissalke,28,54,0,0,HOU,82,0,34.14634146,#DIV/0!,#DIV/0!,#DIV/0!,28,82
LEONABO01 ,1977,1,Bob,Leonard,31,51,0,0,IND,82,0,37.80487805,#DIV/0!,#DIV/0!,#DIV/0!,31,82
JOHNSPH01 ,1977,1,Phil,Johnson,13,24,0,0,KCK,37,0,35.13513514,#DIV/0!,#DIV/0!,#DIV/0!,13,37
STAVELA01 ,1977,2,Larry,Staverman,18,27,0,0,KCK,45,0,40,#DIV/0!,#DIV/0!,#DIV/0!,18,45
MACAUED01 ,1959,1,Ed,Macauley,46,29,7,7,STL,75,14,61.33333333,50,55.66666667,1,53,89
MOEDO01   ,1987,1,Doug,Moe,54,28,5,6,DEN,82,11,65.85365854,45.45454545,55.654102,1,59,93
LOUGHKE01 ,1977,1,Kevin,Loughery,24,58,0,0,NJN,82,0,29.26829268,#DIV/0!,#DIV/0!,#DIV/0!,24,82
BAYLOEL01 ,1977,1,Elgin,Baylor,39,43,0,0,NOJ,82,0,47.56097561,#DIV/0!,#DIV/0!,#DIV/0!,39,82
MCGUIFR01 ,1961,1,Frank,McGuire,49,31,6,6,PH1,80,12,61.25,50,55.625,1,55,92
SHUEGE01  ,1977,1,Gene,Shue,2,4,0,0,PHI,6,0,33.33333333,#DIV/0!,#DIV/0!,#DIV/0!,2,6
MOTTADI01 ,1974,1,Dick,Motta,47,35,7,6,CHI,82,13,57.31707317,53.84615385,55.58161351,1,54,95
MACLEJO01 ,1977,1,John,MacLeod,49,33,0,2,PHO,82,2,59.75609756,0,29.87804878,0,49,84
HARRILE01 ,1953,1,Les,Harrison,44,28,3,3,ROC,72,6,61.11111111,50,55.55555556,1,47,78
NELSODO01 ,1983,1,Don,Nelson,50,32,8,8,MIL,82,16,60.97560976,50,55.48780488,1,58,98
HOPKIBO01 ,1977,1,Bob,Hopkins,5,17,0,0,SEA,22,0,22.72727273,#DIV/0!,#DIV/0!,#DIV/0!,5,22
NELSODO01 ,1986,1,Don,Nelson,50,32,6,6,MIL,82,12,60.97560976,50,55.48780488,1,56,94
FRATEMI01 ,1987,1,Mike,Fratello,50,32,6,6,ATL,82,12,60.97560976,50,55.48780488,1,56,94
JACKSPH01 ,2002,1,Phil,Jackson,50,32,6,6,LAL,82,12,60.97560976,50,55.48780488,1,56,94
SANDETO01 ,1978,1,Tom,Sanders,2,12,0,0,BOS,14,0,14.28571429,#DIV/0!,#DIV/0!,#DIV/0!,2,14
COWENDA01 ,1978,2,Dave,Cowens,27,41,0,0,BOS,68,0,39.70588235,#DIV/0!,#DIV/0!,#DIV/0!,27,68
COSTELA01 ,1978,1,Larry,Costello,20,36,0,0,CHI,56,0,35.71428571,#DIV/0!,#DIV/0!,#DIV/0!,20,56
ROBERSC01 ,1978,2,Scotty,Robertson,11,15,0,0,CHI,26,0,42.30769231,#DIV/0!,#DIV/0!,#DIV/0!,11,26
FITCHBI01 ,1978,1,Bill,Fitch,30,52,0,0,CLE,82,0,36.58536585,#DIV/0!,#DIV/0!,#DIV/0!,30,82
BROWNLA01 ,1978,1,Larry,Brown,28,25,0,0,DEN,53,0,52.83018868,#DIV/0!,#DIV/0!,#DIV/0!,28,53
BARKECL01 ,1949,1,Cliff,Barker,39,25,3,3,INI,64,6,60.9375,50,55.46875,1,42,70
VITALDI01 ,1978,1,Dick,Vitale,30,52,0,0,DET,82,0,36.58536585,#DIV/0!,#DIV/0!,#DIV/0!,30,82
ATTLEAL01 ,1978,1,Al,Attles,38,44,0,0,GSW,82,0,46.34146341,#DIV/0!,#DIV/0!,#DIV/0!,38,82
NISSATO01 ,1978,1,Tom,Nissalke,47,35,0,2,HOU,82,2,57.31707317,0,28.65853659,0,47,84
LEONABO01 ,1978,1,Bob,Leonard,38,44,0,0,IND,82,0,46.34146341,#DIV/0!,#DIV/0!,#DIV/0!,38,82
POPOVGR01 ,2001,1,Gregg,Popovich,58,24,4,6,SAS,82,10,70.73170732,40,55.36585366,1,62,92
SLOANJE01 ,1990,1,Jerry,Sloan,54,28,4,5,UTA,82,9,65.85365854,44.44444444,55.14905149,1,58,91
NELSODO01 ,1978,1,Don,Nelson,38,44,0,0,MIL,82,0,46.34146341,#DIV/0!,#DIV/0!,#DIV/0!,38,82
LOUGHKE01 ,1978,1,Kevin,Loughery,37,45,0,2,NJN,82,2,45.12195122,0,22.56097561,0,37,84
BAYLOEL01 ,1978,1,Elgin,Baylor,26,56,0,0,NOJ,82,0,31.70731707,#DIV/0!,#DIV/0!,#DIV/0!,26,82
COLLIDO01 ,1988,1,Doug,Collins,47,35,9,8,CHI,82,17,57.31707317,52.94117647,55.12912482,1,56,99
HOLZMRE01 ,1978,2,Red,Holzman,25,43,0,0,NYK,68,0,36.76470588,#DIV/0!,#DIV/0!,#DIV/0!,25,68
JOHNSNE01 ,1959,1,Neil,Johnston,49,26,4,5,PH1,75,9,65.33333333,44.44444444,54.88888889,1,53,84
NISSATO01 ,1976,1,Tom,Nissalke,49,33,6,6,HOU,82,12,59.75609756,50,54.87804878,1,55,94
BROWNLA01 ,1999,1,Larry,Brown,49,33,5,5,PHI,82,10,59.75609756,50,54.87804878,1,54,92
WILKELE01 ,1988,1,Lenny,Wilkens,57,25,2,3,CLE,82,5,69.51219512,40,54.75609756,1,59,87
SHUEGE01  ,1978,1,Gene,Shue,43,39,0,0,SDC,82,0,52.43902439,#DIV/0!,#DIV/0!,#DIV/0!,43,82
NELSODO01 ,1984,1,Don,Nelson,59,23,3,5,MIL,82,8,71.95121951,37.5,54.72560976,1,62,90
OLSENHA01 ,1946,1,Harold,Olsen,39,22,5,6,CH1,61,11,63.93442623,45.45454545,54.69448584,1,44,72
HEINSTO01 ,1976,1,Tom,Heinsohn,44,38,5,4,BOS,82,9,53.65853659,55.55555556,54.60704607,1,49,91
NELSODO01 ,1977,1,Don,Nelson,44,38,5,4,MIL,82,9,53.65853659,55.55555556,54.60704607,1,49,91
SLOANJE01 ,1979,1,Jerry,Sloan,30,52,0,0,CHI,82,0,36.58536585,#DIV/0!,#DIV/0!,#DIV/0!,30,82
ALBECST01 ,1979,1,Stan,Albeck,37,45,0,0,CLE,82,0,45.12195122,#DIV/0!,#DIV/0!,#DIV/0!,37,82
WALSHDO01 ,1979,1,Donnie,Walsh,30,52,0,0,DEN,82,0,36.58536585,#DIV/0!,#DIV/0!,#DIV/0!,30,82
VITALDI01 ,1979,1,Dick,Vitale,4,8,0,0,DET,12,0,33.33333333,#DIV/0!,#DIV/0!,#DIV/0!,4,12
ADUBARI01 ,1979,2,Richie,Adubato,12,58,0,0,DET,70,0,17.14285714,#DIV/0!,#DIV/0!,#DIV/0!,12,70
ATTLEAL01 ,1979,1,Al,Attles,18,43,0,0,GSW,61,0,29.50819672,#DIV/0!,#DIV/0!,#DIV/0!,18,61
BACHJO01  ,1979,2,John,Bach,6,15,0,0,GSW,21,0,28.57142857,#DIV/0!,#DIV/0!,#DIV/0!,6,21
SKILESC01 ,1999,2,Scott,Skiles,40,22,4,5,PHO,62,9,64.51612903,44.44444444,54.48028674,1,44,71
LEONABO01 ,1979,1,Bob,Leonard,37,45,0,0,IND,82,0,45.12195122,#DIV/0!,#DIV/0!,#DIV/0!,37,82
MENDEMU01 ,1949,1,Murray,Mendenhall,40,28,2,2,DET,68,4,58.82352941,50,54.41176471,1,42,72
MCKINJA01 ,1979,1,Jack,McKinney,10,4,0,0,LAL,14,0,71.42857143,#DIV/0!,#DIV/0!,#DIV/0!,10,14
MCMAHJA01 ,1963,1,Jack,McMahon,55,25,4,6,CIN,80,10,68.75,40,54.375,1,59,90
KARLGE01  ,1991,3,George,Karl,27,15,4,5,SEA,42,9,64.28571429,44.44444444,54.36507937,1,31,51
LOUGHKE01 ,1979,1,Kevin,Loughery,34,48,0,0,NJN,82,0,41.46341463,#DIV/0!,#DIV/0!,#DIV/0!,34,82
HOLZMRE01 ,1979,1,Red,Holzman,39,43,0,0,NYK,82,0,47.56097561,#DIV/0!,#DIV/0!,#DIV/0!,39,82
HARRIDE01 ,1994,1,Del,Harris,48,34,5,5,LAL,82,10,58.53658537,50,54.26829268,1,53,92
BROWNLA01 ,2002,1,Larry,Brown,48,34,6,6,PHI,82,12,58.53658537,50,54.26829268,1,54,94
MOEDO01   ,1978,1,Doug,Moe,48,34,7,7,SAS,82,14,58.53658537,50,54.26829268,1,55,96
MOEDO01   ,1979,1,Doug,Moe,33,33,0,0,SAS,66,0,50,#DIV/0!,#DIV/0!,#DIV/0!,33,66
HANNUAL01 ,1956,3,Alex,Hannum,15,16,6,4,STL,31,10,48.38709677,60,54.19354839,1,21,41
SHUEGE01  ,1979,1,Gene,Shue,35,47,0,0,SDC,82,0,42.68292683,#DIV/0!,#DIV/0!,#DIV/0!,35,82
CARLIRI01 ,2002,1,Rick,Carlisle,50,32,8,9,DET,82,17,60.97560976,47.05882353,54.01721664,1,58,99
NISSATO01 ,1979,1,Tom,Nissalke,24,58,0,0,UTA,82,0,29.26829268,#DIV/0!,#DIV/0!,#DIV/0!,24,82
MOTTADI01 ,1979,1,Dick,Motta,39,43,0,2,WA1,82,2,47.56097561,0,23.7804878,0,39,84
BROWNHU01 ,1980,1,Hubie,Brown,31,48,0,0,ATL,79,0,39.24050633,#DIV/0!,#DIV/0!,#DIV/0!,31,79
FRATEMI01 ,1980,2,Mike,Fratello,0,3,0,0,ATL,3,0,0,#DIV/0!,#DIV/0!,#DIV/0!,0,3
MOOREDO01 ,1949,3,Doxie,Moore,15,11,4,4,AND,26,8,57.69230769,50,53.84615385,1,19,34
DALYCH01  ,1990,1,Chuck,Daly,50,32,7,8,DET,82,15,60.97560976,46.66666667,53.82113821,1,57,97
MUSSEBI01 ,1980,1,Bill,Musselman,25,46,0,0,CLE,71,0,35.21126761,#DIV/0!,#DIV/0!,#DIV/0!,25,71
DELANDO01 ,1980,2,Don,Delaney,3,8,0,0,CLE,11,0,27.27272727,#DIV/0!,#DIV/0!,#DIV/0!,3,11
MOTTADI01 ,1980,1,Dick,Motta,15,67,0,0,DAL,82,0,18.29268293,#DIV/0!,#DIV/0!,#DIV/0!,15,82
WALSHDO01 ,1980,1,Donnie,Walsh,11,20,0,0,DEN,31,0,35.48387097,#DIV/0!,#DIV/0!,#DIV/0!,11,31
MOEDO01   ,1980,2,Doug,Moe,26,25,0,0,DEN,51,0,50.98039216,#DIV/0!,#DIV/0!,#DIV/0!,26,51
ROBERSC01 ,1980,1,Scotty,Robertson,21,61,0,0,DET,82,0,25.6097561,#DIV/0!,#DIV/0!,#DIV/0!,21,82
ATTLEAL01 ,1980,1,Al,Attles,39,43,0,0,GSW,82,0,47.56097561,#DIV/0!,#DIV/0!,#DIV/0!,39,82
KUNDLJO01 ,1950,1,John,Kundla,44,24,3,4,MIE,68,7,64.70588235,42.85714286,53.78151261,1,47,75
MCKINJA01 ,1980,1,Jack,McKinney,44,38,0,2,IND,82,2,53.65853659,0,26.82926829,0,44,84
GALLAHA01 ,1963,1,Harry,Gallatin,46,34,6,6,STL,80,12,57.5,50,53.75,1,52,92
BROWNHU01 ,1983,1,Hubie,Brown,47,35,6,6,NYK,82,12,57.31707317,50,53.65853659,1,53,94
MOEDO01   ,1985,1,Doug,Moe,47,35,5,5,DEN,82,10,57.31707317,50,53.65853659,1,52,92
LOUGHKE01 ,1980,1,Kevin,Loughery,12,23,0,0,NJN,35,0,34.28571429,#DIV/0!,#DIV/0!,#DIV/0!,12,35
MACKIBO01 ,1980,2,Bob,MacKinnon,12,35,0,0,NJN,47,0,25.53191489,#DIV/0!,#DIV/0!,#DIV/0!,12,47
HOLZMRE01 ,1980,1,Red,Holzman,50,32,0,2,NYK,82,2,60.97560976,0,30.48780488,0,50,84
JACKSPH01 ,1994,1,Phil,Jackson,47,35,5,5,CHI,82,10,57.31707317,50,53.65853659,1,52,92
WILKELE01 ,2000,1,Lenny,Wilkens,47,35,6,6,TOR,82,12,57.31707317,50,53.65853659,1,53,94
SLOANJE01 ,1989,1,Jerry,Sloan,55,27,2,3,UTA,82,5,67.07317073,40,53.53658537,1,57,87
RILEYPA01 ,1997,1,Pat,Riley,55,27,2,3,MIA,82,5,67.07317073,40,53.53658537,1,57,87
SILASPA01 ,1980,1,Paul,Silas,36,46,0,0,SDC,82,0,43.90243902,#DIV/0!,#DIV/0!,#DIV/0!,36,82
WILKELE01 ,1980,1,Lenny,Wilkens,34,48,0,0,SEA,82,0,41.46341463,#DIV/0!,#DIV/0!,#DIV/0!,34,82
NISSATO01 ,1980,1,Tom,Nissalke,28,54,0,0,UTA,82,0,34.14634146,#DIV/0!,#DIV/0!,#DIV/0!,28,82
SHUEGE01  ,1980,1,Gene,Shue,39,43,0,0,WA1,82,0,47.56097561,#DIV/0!,#DIV/0!,#DIV/0!,39,82
LOUGHKE01 ,1981,1,Kevin,Loughery,42,40,0,2,ATL,82,2,51.2195122,0,25.6097561,0,42,84
SLOANJE01 ,1999,1,Jerry,Sloan,55,27,4,6,UTA,82,10,67.07317073,40,53.53658537,1,59,92
SLOANJE01 ,1981,1,Jerry,Sloan,19,32,0,0,CHI,51,0,37.25490196,#DIV/0!,#DIV/0!,#DIV/0!,19,51
JOHNSPH01 ,1981,2,Phil,Johnson,0,1,0,0,CHI,1,0,0,#DIV/0!,#DIV/0!,#DIV/0!,0,1
THORNRO01 ,1981,2,Rod,Thorn,15,15,0,0,CHI,30,0,50,#DIV/0!,#DIV/0!,#DIV/0!,15,30
DELANDO01 ,1981,1,Don,Delaney,4,11,0,0,CLE,15,0,26.66666667,#DIV/0!,#DIV/0!,#DIV/0!,4,15
KLOPPBO01 ,1981,2,Bob,Kloppenburg,0,3,0,0,CLE,3,0,0,#DIV/0!,#DIV/0!,#DIV/0!,0,3
DALYCH01  ,1981,3,Chuck,Daly,9,32,0,0,CLE,41,0,21.95121951,#DIV/0!,#DIV/0!,#DIV/0!,9,41
MUSSEBI01 ,1981,4,Bill,Musselman,2,21,0,0,CLE,23,0,8.695652174,#DIV/0!,#DIV/0!,#DIV/0!,2,23
MOTTADI01 ,1981,1,Dick,Motta,28,54,0,0,DAL,82,0,34.14634146,#DIV/0!,#DIV/0!,#DIV/0!,28,82
SCHAUFR01 ,1964,1,Fred,Schaus,49,31,5,6,LAL,80,11,61.25,45.45454545,53.35227273,1,54,91
ROBERSC01 ,1981,1,Scotty,Robertson,39,43,0,0,DET,82,0,47.56097561,#DIV/0!,#DIV/0!,#DIV/0!,39,82
ATTLEAL01 ,1981,1,Al,Attles,45,37,0,0,GSW,82,0,54.87804878,#DIV/0!,#DIV/0!,#DIV/0!,45,82
COWENDA01 ,1997,1,Dave,Cowens,51,31,4,5,CHA,82,9,62.19512195,44.44444444,53.3197832,1,55,91
MCKINJA01 ,1981,1,Jack,McKinney,35,47,0,0,IND,82,0,42.68292683,#DIV/0!,#DIV/0!,#DIV/0!,35,82
FITZSCO01 ,1981,1,Cotton,Fitzsimmons,30,52,0,0,KCK,82,0,36.58536585,#DIV/0!,#DIV/0!,#DIV/0!,30,82
WESTHPA01 ,1981,1,Paul,Westhead,7,4,0,0,LAL,11,0,63.63636364,#DIV/0!,#DIV/0!,#DIV/0!,7,11
VANGUJE01 ,1995,2,Jeff,Van Gundy,13,10,4,4,NYK,23,8,56.52173913,50,53.26086957,1,17,31
COSTELA01 ,1972,1,Larry,Costello,60,22,2,4,MIL,82,6,73.17073171,33.33333333,53.25203252,1,62,88
BROWNLA01 ,1981,1,Larry,Brown,44,38,0,2,NJN,82,2,53.65853659,0,26.82926829,0,44,84
HOLZMRE01 ,1981,1,Red,Holzman,33,49,0,0,NYK,82,0,40.24390244,#DIV/0!,#DIV/0!,#DIV/0!,33,82
SCOTTRA01 ,1973,1,Ray,Scott,52,30,3,4,DET,82,7,63.41463415,42.85714286,53.1358885,1,55,89
ALBECST01 ,1980,1,Stan,Albeck,52,30,3,4,SAS,82,7,63.41463415,42.85714286,53.1358885,1,55,89
RAMSAJA01 ,1981,1,Jack,Ramsay,42,40,0,0,POR,82,0,51.2195122,#DIV/0!,#DIV/0!,#DIV/0!,42,82
SCHAUFR01 ,1965,1,Fred,Schaus,45,35,7,7,LAL,80,14,56.25,50,53.125,1,52,94
SILASPA01 ,1981,1,Paul,Silas,17,65,0,0,SDC,82,0,20.73170732,#DIV/0!,#DIV/0!,#DIV/0!,17,82
SEYMOPA01 ,1960,1,Paul,Seymour,51,28,5,7,STL,79,12,64.55696203,41.66666667,53.11181435,1,56,91
NISSATO01 ,1981,1,Tom,Nissalke,8,12,0,0,UTA,20,0,40,#DIV/0!,#DIV/0!,#DIV/0!,8,20
LAYDEFR01 ,1981,2,Frank,Layden,17,45,0,0,UTA,62,0,27.41935484,#DIV/0!,#DIV/0!,#DIV/0!,17,62
ATTLEAL01 ,1976,1,Al,Attles,46,36,5,5,GSW,82,10,56.09756098,50,53.04878049,1,51,92
RILEYPA01 ,1998,1,Pat,Riley,33,17,2,3,MIA,50,5,66,40,53,1,35,55
HARRIDE01 ,1980,1,Del,Harris,40,42,12,9,HOU,82,21,48.7804878,57.14285714,52.96167247,1,52,103
WESTHPA01 ,1982,1,Paul,Westhead,28,54,0,0,CHI,82,0,34.14634146,#DIV/0!,#DIV/0!,#DIV/0!,28,82
NISSATO01 ,1982,1,Tom,Nissalke,23,59,0,0,CLE,82,0,28.04878049,#DIV/0!,#DIV/0!,#DIV/0!,23,82
MOTTADI01 ,1982,1,Dick,Motta,38,44,0,0,DAL,82,0,46.34146341,#DIV/0!,#DIV/0!,#DIV/0!,38,82
FITCHBI01 ,1975,1,Bill,Fitch,49,33,6,7,CLE,82,13,59.75609756,46.15384615,52.95497186,1,55,95
ROBERSC01 ,1982,1,Scotty,Robertson,37,45,0,0,DET,82,0,45.12195122,#DIV/0!,#DIV/0!,#DIV/0!,37,82
ATTLEAL01 ,1982,1,Al,Attles,30,52,0,0,GSW,82,0,36.58536585,#DIV/0!,#DIV/0!,#DIV/0!,30,82
HARRIDE01 ,1982,1,Del,Harris,14,68,0,0,HOU,82,0,17.07317073,#DIV/0!,#DIV/0!,#DIV/0!,14,82
MCKINJA01 ,1982,1,Jack,McKinney,20,62,0,0,IND,82,0,24.3902439,#DIV/0!,#DIV/0!,#DIV/0!,20,82
FITZSCO01 ,1982,1,Cotton,Fitzsimmons,45,37,0,0,KCK,82,0,54.87804878,#DIV/0!,#DIV/0!,#DIV/0!,45,82
COLLIDO01 ,1996,1,Doug,Collins,54,28,2,3,DET,82,5,65.85365854,40,52.92682927,1,56,87
BROWNLA01 ,1991,2,Larry,Brown,23,12,2,3,LAC,35,5,65.71428571,40,52.85714286,1,25,40
BROWNLA01 ,1982,1,Larry,Brown,47,29,0,0,NJN,76,0,61.84210526,#DIV/0!,#DIV/0!,#DIV/0!,47,76
BLAIRBI01 ,1982,2,Bill,Blair,2,4,0,2,NJN,6,2,33.33333333,0,16.66666667,0,2,8
CERVIAL01 ,1950,1,Al,Cervi,32,34,4,3,SYR,66,7,48.48484848,57.14285714,52.81385281,1,36,73
FRATEMI01 ,1985,1,Mike,Fratello,50,32,4,5,ATL,82,9,60.97560976,44.44444444,52.7100271,1,54,91
MOTTADI01 ,1970,1,Dick,Motta,51,31,3,4,CHI,82,7,62.19512195,42.85714286,52.5261324,1,54,89
MOTTADI01 ,1972,1,Dick,Motta,51,31,3,4,CHI,82,7,62.19512195,42.85714286,52.5261324,1,54,89
GUERIRI01 ,1965,1,Richie,Guerin,36,44,6,4,STL,80,10,45,60,52.5,1,42,90
SILASPA01 ,1982,1,Paul,Silas,25,57,0,0,SDC,82,0,30.48780488,#DIV/0!,#DIV/0!,#DIV/0!,25,82
WILKELE01 ,1982,1,Lenny,Wilkens,48,34,0,2,SEA,82,2,58.53658537,0,29.26829268,0,48,84
LAYDEFR01 ,1982,1,Frank,Layden,30,52,0,0,UTA,82,0,36.58536585,#DIV/0!,#DIV/0!,#DIV/0!,30,82
SHUEGE01  ,1982,1,Gene,Shue,42,40,0,0,WA1,82,0,51.2195122,#DIV/0!,#DIV/0!,#DIV/0!,42,82
BROWNLA01 ,1977,1,Larry,Brown,48,34,6,7,DEN,82,13,58.53658537,46.15384615,52.34521576,1,54,95
LYNAMJI01 ,1989,1,Jim,Lynam,53,29,4,6,PHI,82,10,64.63414634,40,52.31707317,1,57,92
LOUGHKE01 ,1983,1,Kevin,Loughery,27,55,0,0,CHI,82,0,32.92682927,#DIV/0!,#DIV/0!,#DIV/0!,27,82
NISSATO01 ,1983,1,Tom,Nissalke,28,54,0,0,CLE,82,0,34.14634146,#DIV/0!,#DIV/0!,#DIV/0!,28,82
NELSODO01 ,2000,1,Don,Nelson,53,29,4,6,DAL,82,10,64.63414634,40,52.31707317,1,57,92
SLOANJE01 ,2000,1,Jerry,Sloan,53,29,2,3,UTA,82,5,64.63414634,40,52.31707317,1,55,87
MACLEJO01 ,1979,1,John,MacLeod,55,27,3,5,PHO,82,8,67.07317073,37.5,52.28658537,1,58,90
BACHJO01  ,1983,1,John,Bach,37,45,0,0,GSW,82,0,45.12195122,#DIV/0!,#DIV/0!,#DIV/0!,37,82
FITCHBI01 ,1983,1,Bill,Fitch,29,53,0,0,HOU,82,0,35.36585366,#DIV/0!,#DIV/0!,#DIV/0!,29,82
MCKINJA01 ,1983,1,Jack,McKinney,26,56,0,0,IND,82,0,31.70731707,#DIV/0!,#DIV/0!,#DIV/0!,26,82
FITZSCO01 ,1983,1,Cotton,Fitzsimmons,38,44,0,3,KCK,82,3,46.34146341,0,23.17073171,0,38,85
ADELMRI01 ,2000,1,Rick,Adelman,55,27,3,5,SAC,82,8,67.07317073,37.5,52.28658537,1,58,90
SCHAYDO01 ,1964,1,Dolph,Schayes,40,40,6,5,PHI,80,11,50,54.54545455,52.27272727,1,46,91
SEYMOPA01 ,1958,1,Paul,Seymour,35,37,5,4,SYR,72,9,48.61111111,55.55555556,52.08333333,1,40,81
RAMSAJA01 ,1977,1,Jack,Ramsay,58,24,2,4,POR,82,6,70.73170732,33.33333333,52.03252033,1,60,88
GUERIRI01 ,1968,1,Richie,Guerin,48,34,5,6,ATL,82,11,58.53658537,45.45454545,51.99556541,1,53,93
MACLEJO01 ,1975,1,John,MacLeod,42,40,10,9,PHO,82,19,51.2195122,52.63157895,51.92554557,1,52,101
SHUEGE01  ,1969,1,Gene,Shue,50,32,3,4,BAL,82,7,60.97560976,42.85714286,51.91637631,1,53,89
MCHONMO01 ,1983,1,Morris,McHone,11,20,0,0,SAS,31,0,35.48387097,#DIV/0!,#DIV/0!,#DIV/0!,11,31
BASSBO01  ,1983,2,Bob,Bass,26,25,0,0,SAS,51,0,50.98039216,#DIV/0!,#DIV/0!,#DIV/0!,26,51
LYNAMJI01 ,1983,1,Jim,Lynam,30,52,0,0,SDC,82,0,36.58536585,#DIV/0!,#DIV/0!,#DIV/0!,30,82
CHEEKMA01 ,2002,1,Maurice,Cheeks,50,32,3,4,POR,82,7,60.97560976,42.85714286,51.91637631,1,53,89
GUERIRI01 ,1966,1,Richie,Guerin,39,42,5,4,STL,81,9,48.14814815,55.55555556,51.85185185,1,44,90
MOTTADI01 ,1985,1,Dick,Motta,44,38,5,5,DAL,82,10,53.65853659,50,51.82926829,1,49,92
FRATEMI01 ,1984,1,Mike,Fratello,34,48,0,0,ATL,82,0,41.46341463,#DIV/0!,#DIV/0!,#DIV/0!,34,82
LYNAMJI01 ,1990,1,Jim,Lynam,44,38,4,4,PHI,82,8,53.65853659,50,51.82926829,1,48,90
CERVIAL01 ,1951,1,Al,Cervi,40,26,3,4,SYR,66,7,60.60606061,42.85714286,51.73160173,1,43,73
CUNNIBI01 ,1983,1,Billy,Cunningham,52,30,2,3,PHI,82,5,63.41463415,40,51.70731707,0,54,87
FRATEMI01 ,1988,1,Mike,Fratello,52,30,2,3,ATL,82,5,63.41463415,40,51.70731707,0,54,87
RODGEJI01 ,1989,1,Jimmy,Rodgers,52,30,2,3,BOS,82,5,63.41463415,40,51.70731707,0,54,87
BROWNLA01 ,1995,1,Larry,Brown,52,30,2,3,IND,82,5,63.41463415,40,51.70731707,0,54,87
BACHJO01  ,1984,1,John,Bach,22,60,0,0,GSW,82,0,26.82926829,#DIV/0!,#DIV/0!,#DIV/0!,22,82
LAPCHJO01 ,1948,1,Joe,Lapchick,32,28,3,3,NYK,60,6,53.33333333,50,51.66666667,0,35,66
IRVINGE01 ,1984,1,George,Irvine,22,60,0,0,IND,82,0,26.82926829,#DIV/0!,#DIV/0!,#DIV/0!,22,82
MCKINJA01 ,1984,1,Jack,McKinney,1,8,0,0,KCK,9,0,11.11111111,#DIV/0!,#DIV/0!,#DIV/0!,1,9
JOHNSPH01 ,1984,2,Phil,Johnson,30,43,0,0,KCK,73,0,41.09589041,#DIV/0!,#DIV/0!,#DIV/0!,30,73
LYNAMJI01 ,1984,1,Jim,Lynam,22,39,0,0,LAC,61,0,36.06557377,#DIV/0!,#DIV/0!,#DIV/0!,22,61
CHANEDO01 ,1984,2,Don,Chaney,9,12,0,0,LAC,21,0,42.85714286,#DIV/0!,#DIV/0!,#DIV/0!,9,21
LOEFFKE01 ,1947,1,Ken,Loeffler,29,19,3,4,ST1,48,7,60.41666667,42.85714286,51.63690476,0,32,55
GUERIRI01 ,1969,1,Richie,Guerin,48,34,4,5,ATL,82,9,58.53658537,44.44444444,51.49051491,0,52,91
ALBECST01 ,1984,1,Stan,Albeck,42,40,0,3,NJN,82,3,51.2195122,0,25.6097561,0,42,85
BROWNHU01 ,1984,1,Hubie,Brown,24,58,0,0,NYK,82,0,29.26829268,#DIV/0!,#DIV/0!,#DIV/0!,24,82
MOTTADI01 ,1976,1,Dick,Motta,48,34,4,5,WA1,82,9,58.53658537,44.44444444,51.49051491,0,52,91
MACLEJO01 ,1984,1,John,MacLeod,36,46,0,3,PHO,82,3,43.90243902,0,21.95121951,0,36,85
ALBECST01 ,1981,1,Stan,Albeck,48,34,4,5,SAS,82,9,58.53658537,44.44444444,51.49051491,0,52,91
MACLEJO01 ,1983,1,John,MacLeod,41,41,9,8,PHO,82,17,50,52.94117647,51.47058824,0,50,99
WILKELE01 ,1984,1,Lenny,Wilkens,31,51,0,0,SEA,82,0,37.80487805,#DIV/0!,#DIV/0!,#DIV/0!,31,82
ATTLEAL01 ,1972,1,Al,Attles,47,35,5,6,GSW,82,11,57.31707317,45.45454545,51.38580931,0,52,93
MACAUED01 ,1958,2,Ed,Macauley,43,19,2,4,STL,62,6,69.35483871,33.33333333,51.34408602,0,45,68
RAMSAJA01 ,1974,1,Jack,Ramsay,49,33,3,4,BUF,82,7,59.75609756,42.85714286,51.30662021,0,52,89
NELSODO01 ,1979,1,Don,Nelson,49,33,3,4,MIL,82,7,59.75609756,42.85714286,51.30662021,0,52,89
ALBECST01 ,1985,1,Stan,Albeck,30,52,0,3,CHI,82,3,36.58536585,0,18.29268293,0,30,85
KARLGE01  ,1985,1,George,Karl,25,42,0,0,CLE,67,0,37.31343284,#DIV/0!,#DIV/0!,#DIV/0!,25,67
LITTLGE01 ,1985,2,Gene,Littles,4,11,0,0,CLE,15,0,26.66666667,#DIV/0!,#DIV/0!,#DIV/0!,4,15
HARRIDE01 ,1988,1,Del,Harris,49,33,3,4,MIL,82,7,59.75609756,42.85714286,51.30662021,0,52,89
WOLFCH01  ,1962,1,Charles,Wolf,42,38,6,6,CIN,80,12,52.5,50,51.25,0,48,92
NELSODO01 ,1988,1,Don,Nelson,43,39,4,4,GSW,82,8,52.43902439,50,51.2195122,0,47,90
BACHJO01  ,1985,1,John,Bach,30,52,0,0,GSW,82,0,36.58536585,#DIV/0!,#DIV/0!,#DIV/0!,30,82
GOTTLED01 ,1947,1,Eddie,Gottlieb,27,21,6,7,PH1,48,13,56.25,46.15384615,51.20192308,0,33,61
IRVINGE01 ,1985,1,George,Irvine,26,56,0,0,IND,82,0,31.70731707,#DIV/0!,#DIV/0!,#DIV/0!,26,82
CHANEDO01 ,1985,1,Don,Chaney,32,50,0,0,LAC,82,0,39.02439024,#DIV/0!,#DIV/0!,#DIV/0!,32,82
RAMBIKU01 ,1998,3,Kurt,Rambis,24,13,3,5,LAL,37,8,64.86486486,37.5,51.18243243,0,27,45
MOTTADI01 ,1973,1,Dick,Motta,54,28,4,7,CHI,82,11,65.85365854,36.36363636,51.10864745,0,58,93
WOHLDA01  ,1985,1,Dave,Wohl,39,43,0,3,NJN,82,3,47.56097561,0,23.7804878,0,39,85
BROWNHU01 ,1985,1,Hubie,Brown,23,59,0,0,NYK,82,0,28.04878049,#DIV/0!,#DIV/0!,#DIV/0!,23,82
BIRCHPA01 ,1952,1,Paul,Birch,36,33,4,4,DET,69,8,52.17391304,50,51.08695652,0,40,77
MACLEJO01 ,1985,1,John,MacLeod,32,50,0,0,PHO,82,0,39.02439024,#DIV/0!,#DIV/0!,#DIV/0!,32,82
HANNUAL01 ,1963,1,Alex,Hannum,48,32,5,7,SFW,80,12,60,41.66666667,50.83333333,0,53,92
JOHNSPH01 ,1985,1,Phil,Johnson,37,45,0,3,SAC,82,3,45.12195122,0,22.56097561,0,37,85
FITZSCO01 ,1985,1,Cotton,Fitzsimmons,35,47,0,3,SAS,82,3,42.68292683,0,21.34146341,0,35,85
BICKEBE01 ,1985,1,Bernie,Bickerstaff,31,51,0,0,SEA,82,0,37.80487805,#DIV/0!,#DIV/0!,#DIV/0!,31,82
GUERIRI01 ,1967,1,Richie,Guerin,56,26,2,4,STL,82,6,68.29268293,33.33333333,50.81300813,0,58,88
SHUEGE01  ,1985,1,Gene,Shue,32,37,0,0,WA1,69,0,46.37681159,#DIV/0!,#DIV/0!,#DIV/0!,32,69
HOLZMRE01 ,1973,1,Red,Holzman,49,33,5,7,NYK,82,12,59.75609756,41.66666667,50.71138211,0,54,94
JONESKC01 ,1975,1,KC,Jones,48,34,3,4,WA1,82,7,58.53658537,42.85714286,50.69686411,0,51,89
FITCHBI01 ,1986,1,Bill,Fitch,42,40,5,5,HOU,82,10,51.2195122,50,50.6097561,0,47,92
COLLIDO01 ,1986,1,Doug,Collins,40,42,0,3,CHI,82,3,48.7804878,0,24.3902439,0,40,85
WILKELE01 ,1986,1,Lenny,Wilkens,31,51,0,0,CLE,82,0,37.80487805,#DIV/0!,#DIV/0!,#DIV/0!,31,82
ISSELDA01 ,1993,1,Dan,Issel,42,40,6,6,DEN,82,12,51.2195122,50,50.6097561,0,48,94
MOEDO01   ,1986,1,Doug,Moe,37,45,0,3,DEN,82,3,45.12195122,0,22.56097561,0,37,85
OLSENHA01 ,1947,1,Harold,Olsen,28,20,3,4,CH1,48,7,58.33333333,42.85714286,50.5952381,0,31,55
WESTJE01  ,1976,1,Jerry,West,53,29,4,7,LAL,82,11,64.63414634,36.36363636,50.49889135,0,57,93
COLLIDO01 ,1987,1,Doug,Collins,50,32,4,6,CHI,82,10,60.97560976,40,50.48780488,0,54,92
CARLIRI01 ,2001,1,Rick,Carlisle,50,32,4,6,DET,82,10,60.97560976,40,50.48780488,0,54,92
CHANEDO01 ,1986,1,Don,Chaney,12,70,0,0,LAC,82,0,14.63414634,#DIV/0!,#DIV/0!,#DIV/0!,12,82
WILKELE01 ,1981,1,Lenny,Wilkens,52,30,3,5,SEA,82,8,63.41463415,37.5,50.45731707,0,55,90
RAMSAJA01 ,1975,1,Jack,Ramsay,46,36,4,5,BUF,82,9,56.09756098,44.44444444,50.27100271,0,50,91
WOHLDA01  ,1986,1,Dave,Wohl,24,58,0,0,NJN,82,0,29.26829268,#DIV/0!,#DIV/0!,#DIV/0!,24,82
BROWNHU01 ,1986,1,Hubie,Brown,4,12,0,0,NYK,16,0,25,#DIV/0!,#DIV/0!,#DIV/0!,4,16
HILLBO01  ,1986,2,Bob,Hill,20,46,0,0,NYK,66,0,30.3030303,#DIV/0!,#DIV/0!,#DIV/0!,20,66
WILKELE01 ,1995,1,Lenny,Wilkens,46,36,4,5,ATL,82,9,56.09756098,44.44444444,50.27100271,0,50,91
MACLEJO01 ,1986,1,John,MacLeod,22,34,0,0,PHO,56,0,39.28571429,#DIV/0!,#DIV/0!,#DIV/0!,22,56
VANARDI01 ,1986,2,Dick,VanArsdale,14,12,0,0,PHO,26,0,53.84615385,#DIV/0!,#DIV/0!,#DIV/0!,14,26
NELSODO01 ,1981,1,Don,Nelson,55,27,2,4,MIL,82,6,67.07317073,33.33333333,50.20325203,0,57,88
JOHNSPH01 ,1986,1,Phil,Johnson,14,32,0,0,SAC,46,0,30.43478261,#DIV/0!,#DIV/0!,#DIV/0!,14,46
REYNOJE01 ,1986,2,Jerry,Reynolds,15,21,0,0,SAC,36,0,41.66666667,#DIV/0!,#DIV/0!,#DIV/0!,15,36
WEISSBO01 ,1986,1,Bob,Weiss,28,54,0,0,SAS,82,0,34.14634146,#DIV/0!,#DIV/0!,#DIV/0!,28,82
ALBECST01 ,1983,1,Stan,Albeck,45,37,5,6,NJN,82,11,54.87804878,45.45454545,50.16629712,0,50,93
LAYDEFR01 ,1983,1,Frank,Layden,45,37,5,6,UTA,82,11,54.87804878,45.45454545,50.16629712,0,50,93
LOUGHKE01 ,1986,1,Kevin,Loughery,42,40,0,3,WA1,82,3,51.2195122,0,25.6097561,0,42,85
MULLAJO01 ,1970,1,Joe,Mullaney,48,34,5,7,LAL,82,12,58.53658537,41.66666667,50.10162602,0,53,94
RAMSAJA01 ,1970,1,Jack,Ramsay,47,35,3,4,PHI,82,7,57.31707317,42.85714286,50.08710801,0,50,89
JONESKC01 ,1973,1,KC,Jones,47,35,3,4,CAP,82,7,57.31707317,42.85714286,50.08710801,0,50,89
HANNUAL01 ,1962,1,Alex,Hannum,48,32,2,3,SYR,80,5,60,40,50,0,50,85
DALYCH01  ,1983,1,Chuck,Daly,49,33,2,3,DET,82,5,59.75609756,40,49.87804878,0,51,87
WESTHPA01 ,1980,1,Paul,Westhead,54,28,1,2,LAL,82,3,65.85365854,33.33333333,49.59349593,0,55,85
WILKELE01 ,1992,1,Lenny,Wilkens,54,28,3,6,CLE,82,9,65.85365854,33.33333333,49.59349593,0,57,91
KARLGE01  ,1987,1,George,Karl,16,48,0,0,GSW,64,0,25,#DIV/0!,#DIV/0!,#DIV/0!,16,64
GREGOED01 ,1987,2,Ed,Gregory,4,14,0,0,GSW,18,0,22.22222222,#DIV/0!,#DIV/0!,#DIV/0!,4,18
RAMSAJA01 ,1982,1,Jack,Ramsay,46,36,3,4,POR,82,7,56.09756098,42.85714286,49.47735192,0,49,89
RAMSAJA01 ,1987,1,Jack,Ramsay,38,44,0,0,IND,82,0,46.34146341,#DIV/0!,#DIV/0!,#DIV/0!,38,82
SHUEGE01  ,1987,1,Gene,Shue,17,65,0,0,LAC,82,0,20.73170732,#DIV/0!,#DIV/0!,#DIV/0!,17,82
WALSHDO01 ,1978,2,Donnie,Walsh,19,10,1,2,DEN,29,3,65.51724138,33.33333333,49.42528736,0,20,32
CERVIAL01 ,1955,1,Al,Cervi,35,37,4,4,SYR,72,8,48.61111111,50,49.30555556,0,39,80
WOHLDA01  ,1987,1,Dave,Wohl,2,13,0,0,NJN,15,0,13.33333333,#DIV/0!,#DIV/0!,#DIV/0!,2,15
MACKIBO01 ,1987,2,Bob,MacKinnon,10,29,0,0,NJN,39,0,25.64102564,#DIV/0!,#DIV/0!,#DIV/0!,10,39
REEDWI01  ,1987,3,Willis,Reed,7,21,0,0,NJN,28,0,25,#DIV/0!,#DIV/0!,#DIV/0!,7,28
RAMSAJA01 ,1983,1,Jack,Ramsay,48,34,2,3,POR,82,5,58.53658537,40,49.26829268,0,50,87
GUOKAMA01 ,1987,1,Matt,Guokas,20,23,0,0,PHI,43,0,46.51162791,#DIV/0!,#DIV/0!,#DIV/0!,20,43
LYNAMJI01 ,1987,2,Jim,Lynam,16,23,0,0,PHI,39,0,41.02564103,#DIV/0!,#DIV/0!,#DIV/0!,16,39
WETZEJO01 ,1987,1,John,Wetzel,28,54,0,0,PHO,82,0,34.14634146,#DIV/0!,#DIV/0!,#DIV/0!,28,82
FITCHBI01 ,1984,1,Bill,Fitch,48,34,2,3,HOU,82,5,58.53658537,40,49.26829268,0,50,87
RUSSEBI01 ,1987,1,Bill,Russell,17,41,0,0,SAC,58,0,29.31034483,#DIV/0!,#DIV/0!,#DIV/0!,17,58
REYNOJE01 ,1987,2,Jerry,Reynolds,7,17,0,0,SAC,24,0,29.16666667,#DIV/0!,#DIV/0!,#DIV/0!,7,24
WEISSBO01 ,1987,1,Bob,Weiss,31,51,0,3,SAS,82,3,37.80487805,0,18.90243902,0,31,85
DALYCH01  ,1991,1,Chuck,Daly,48,34,2,3,DET,82,5,58.53658537,40,49.26829268,0,50,87
VANGUJE01 ,2000,1,Jeff,Van Gundy,48,34,2,3,NYK,82,5,58.53658537,40,49.26829268,0,50,87
LOUGHKE01 ,1987,1,Kevin,Loughery,8,19,0,0,WA1,27,0,29.62962963,#DIV/0!,#DIV/0!,#DIV/0!,8,27
KUNDLJO01 ,1954,1,John,Kundla,40,32,3,4,MIE,72,7,55.55555556,42.85714286,49.20634921,0,43,79
NELSODO01 ,1990,1,Don,Nelson,44,38,4,5,GSW,82,9,53.65853659,44.44444444,49.05149051,0,48,91
RODGEJI01 ,1988,1,Jimmy,Rodgers,42,40,0,3,BOS,82,3,51.2195122,0,25.6097561,0,42,85
HARTIDI01 ,1988,1,Dick,Hartier,20,62,0,0,CHA,82,0,24.3902439,#DIV/0!,#DIV/0!,#DIV/0!,20,82
BRISTAL01 ,1992,1,Allan,Bristow,44,38,4,5,CHA,82,9,53.65853659,44.44444444,49.05149051,0,48,91
SILASPA01 ,2001,1,Paul,Silas,44,38,4,5,CHA,82,9,53.65853659,44.44444444,49.05149051,0,48,91
MACLEJO01 ,1988,1,John,MacLeod,38,44,0,0,DAL,82,0,46.34146341,#DIV/0!,#DIV/0!,#DIV/0!,38,82
MOEDO01   ,1988,1,Doug,Moe,44,38,0,3,DEN,82,3,53.65853659,0,26.82926829,0,44,85
HANNUAL01 ,1960,1,Alex,Hannum,38,41,4,4,SYR,79,8,48.10126582,50,49.05063291,0,42,87
BICKEBE01 ,1988,1,Bernie,Bickerstaff,46,30,3,5,SEA,76,8,60.52631579,37.5,49.01315789,0,49,84
GENTRAL01 ,1998,1,Alvin,Gentry,29,21,2,3,DET,50,5,58,40,49,0,31,55
RAMSAJA01 ,1988,1,Jack,Ramsay,0,7,0,0,IND,7,0,0,#DIV/0!,#DIV/0!,#DIV/0!,0,7
DANIEME01 ,1988,2,Mel,Daniels,0,2,0,0,IND,2,0,0,#DIV/0!,#DIV/0!,#DIV/0!,0,2
IRVINGE01 ,1988,3,George,Irvine,6,14,0,0,IND,20,0,30,#DIV/0!,#DIV/0!,#DIV/0!,6,20
VERSADI01 ,1988,4,Dick,Versace,22,31,0,0,IND,53,0,41.50943396,#DIV/0!,#DIV/0!,#DIV/0!,22,53
SHUEGE01  ,1988,1,Gene,Shue,10,28,0,0,LAC,38,0,26.31578947,#DIV/0!,#DIV/0!,#DIV/0!,10,38
CASEYDO01 ,1988,2,Don,Casey,11,33,0,0,LAC,44,0,25,#DIV/0!,#DIV/0!,#DIV/0!,11,44
MACLEJO01 ,1982,1,John,MacLeod,53,29,1,2,PHO,82,3,64.63414634,33.33333333,48.98373984,0,54,85
ROTHSRO01 ,1988,1,Ron,Rothstein,15,67,0,0,MIA,82,0,18.29268293,#DIV/0!,#DIV/0!,#DIV/0!,15,82
BICKEBE01 ,1986,1,Bernie,Bickerstaff,39,43,7,7,SEA,82,14,47.56097561,50,48.7804878,0,46,96
REEDWI01  ,1988,1,Willis,Reed,26,56,0,0,NJN,82,0,31.70731707,#DIV/0!,#DIV/0!,#DIV/0!,26,82
COLANJE01 ,1969,2,Jerry,Colangelo,24,20,3,4,PHO,44,7,54.54545455,42.85714286,48.7012987,0,27,51
LYNAMJI01 ,1988,1,Jim,Lynam,46,36,0,3,PHI,82,3,56.09756098,0,28.04878049,0,46,85
VANGUST01 ,2003,1,Stan,Van Gundy,42,40,6,7,MIA,82,13,51.2195122,46.15384615,48.68667917,0,48,95
SCHULMI01 ,1988,1,Mike,Schuler,25,22,0,0,POR,47,0,53.19148936,#DIV/0!,#DIV/0!,#DIV/0!,25,47
ADELMRI01 ,1988,2,Rick,Adelman,14,21,0,3,POR,35,3,40,0,20,0,14,38
REYNOJE01 ,1988,1,Jerry,Reynolds,27,55,0,0,SAC,82,0,32.92682927,#DIV/0!,#DIV/0!,#DIV/0!,27,82
BROWNLA01 ,1988,1,Larry,Brown,21,61,0,0,SAS,82,0,25.6097561,#DIV/0!,#DIV/0!,#DIV/0!,21,82
SLOANJE01 ,1992,1,Jerry,Sloan,47,35,2,3,UTA,82,5,57.31707317,40,48.65853659,0,49,87
NEWELTO01 ,1988,2,Tom,Newell,0,1,0,0,SEA,1,0,0,#DIV/0!,#DIV/0!,#DIV/0!,0,1
KLOPPBO01 ,1988,3,Bob,Kloppenburg,1,4,0,0,SEA,5,0,20,#DIV/0!,#DIV/0!,#DIV/0!,1,5
LAYDEFR01 ,1988,1,Frank,Layden,11,6,0,0,UTA,17,0,64.70588235,#DIV/0!,#DIV/0!,#DIV/0!,11,17
SLOANJE01 ,1988,2,Jerry,Sloan,40,25,0,3,UTA,65,3,61.53846154,0,30.76923077,0,40,68
UNSELWE01 ,1988,1,Wes,Unseld,40,42,0,0,WA1,82,0,48.7804878,#DIV/0!,#DIV/0!,#DIV/0!,40,82
FRATEMI01 ,1989,1,Mike,Fratello,41,41,0,0,ATL,82,0,50,#DIV/0!,#DIV/0!,#DIV/0!,41,82
RUSSEBI01 ,1974,1,Bill,Russell,43,39,4,5,SEA,82,9,52.43902439,44.44444444,48.44173442,0,47,91
HARTIDI01 ,1989,1,Dick,Hartier,8,32,0,0,CHA,40,0,20,#DIV/0!,#DIV/0!,#DIV/0!,8,40
LITTLGE01 ,1989,2,Gene,Littles,11,31,0,0,CHA,42,0,26.19047619,#DIV/0!,#DIV/0!,#DIV/0!,11,42
FITCHBI01 ,1982,1,Bill,Fitch,56,26,2,5,BOS,82,7,68.29268293,28.57142857,48.43205575,0,58,89
MOEDO01   ,1977,1,Doug,Moe,52,30,2,4,SAS,82,6,63.41463415,33.33333333,48.37398374,0,54,88
MACLEJO01 ,1989,1,John,MacLeod,5,6,0,0,DAL,11,0,45.45454545,#DIV/0!,#DIV/0!,#DIV/0!,5,11
ADUBARI01 ,1989,2,Richie,Adubato,42,29,0,3,DAL,71,3,59.15492958,0,29.57746479,0,42,74
MOEDO01   ,1989,1,Doug,Moe,43,39,0,3,DEN,82,3,52.43902439,0,26.2195122,0,43,85
SEYMOPA01 ,1956,2,Paul,Seymour,34,26,2,3,SYR,60,5,56.66666667,40,48.33333333,0,36,65
NELSODO01 ,1989,1,Don,Nelson,37,45,0,0,GSW,82,0,45.12195122,#DIV/0!,#DIV/0!,#DIV/0!,37,82
MCMAHJA01 ,1965,1,Jack,McMahon,45,35,2,3,CIN,80,5,56.25,40,48.125,0,47,85
VERSADI01 ,1989,1,Dick,Versace,42,40,0,3,IND,82,3,51.2195122,0,25.6097561,0,42,85
CASEYDO01 ,1989,1,Don,Casey,30,52,0,0,LAC,82,0,36.58536585,#DIV/0!,#DIV/0!,#DIV/0!,30,82
MCGUIDI01 ,1961,1,Dick,McGuire,37,43,5,5,DET,80,10,46.25,50,48.125,0,42,90
ROTHSRO01 ,1989,1,Ron,Rothstein,18,64,0,0,MIA,82,0,21.95121951,#DIV/0!,#DIV/0!,#DIV/0!,18,82
JEANNBU01 ,1964,1,Buddy,Jeannette,37,43,5,5,BAL,80,10,46.25,50,48.125,0,42,90
MUSSEBI01 ,1989,1,Bill,Musselman,22,60,0,0,MIN,82,0,26.82926829,#DIV/0!,#DIV/0!,#DIV/0!,22,82
FITCHBI01 ,1989,1,Bill,Fitch,17,65,0,0,NJN,82,0,20.73170732,#DIV/0!,#DIV/0!,#DIV/0!,17,82
HARRILE01 ,1952,1,Les,Harrison,44,26,1,2,ROC,70,3,62.85714286,33.33333333,48.0952381,0,45,73
GUOKAMA01 ,1989,1,Matt,Guokas,18,64,0,0,ORL,82,0,21.95121951,#DIV/0!,#DIV/0!,#DIV/0!,18,82
HILLBO01  ,1990,2,Bob,Hill,32,25,2,3,IND,57,5,56.14035088,40,48.07017544,0,34,62
TOMJARU01 ,1995,1,Rudy,Tomjanovich,48,34,3,5,HOU,82,8,58.53658537,37.5,48.01829268,0,51,90
HOLZMRE01 ,1955,1,Red,Holzman,33,39,4,4,STL,72,8,45.83333333,50,47.91666667,0,37,80
REYNOJE01 ,1989,1,Jerry,Reynolds,7,21,0,0,SAC,28,0,25,#DIV/0!,#DIV/0!,#DIV/0!,7,28
MOTTADI01 ,1989,2,Dick,Motta,16,38,0,0,SAC,54,0,29.62962963,#DIV/0!,#DIV/0!,#DIV/0!,16,54
SHUEGE01  ,1970,1,Gene,Shue,42,40,8,10,BAL,82,18,51.2195122,44.44444444,47.83197832,0,50,100
BICKEBE01 ,1989,1,Bernie,Bickerstaff,41,41,0,0,SEA,82,0,50,#DIV/0!,#DIV/0!,#DIV/0!,41,82
RAMSAJA01 ,1984,1,Jack,Ramsay,42,40,4,5,POR,82,9,51.2195122,44.44444444,47.83197832,0,46,91
UNSELWE01 ,1989,1,Wes,Unseld,31,51,0,0,WA1,82,0,37.80487805,#DIV/0!,#DIV/0!,#DIV/0!,31,82
LOEFFKE01 ,1946,1,Ken,Loeffler,38,23,1,2,ST1,61,3,62.29508197,33.33333333,47.81420765,0,39,64
SCHAUFR01 ,1960,1,Fred,Schaus,36,43,6,6,LAL,79,12,45.56962025,50,47.78481013,0,42,91
LITTLGE01 ,1990,1,Gene,Littles,26,56,0,0,CHA,82,0,31.70731707,#DIV/0!,#DIV/0!,#DIV/0!,26,82
HOLZMRE01 ,1967,2,Red,Holzman,28,17,2,4,NYK,45,6,62.22222222,33.33333333,47.77777778,0,30,51
WILKELE01 ,1990,1,Lenny,Wilkens,33,49,0,0,CLE,82,0,40.24390244,#DIV/0!,#DIV/0!,#DIV/0!,33,82
ADUBARI01 ,1990,1,Richie,Adubato,28,54,0,0,DAL,82,0,34.14634146,#DIV/0!,#DIV/0!,#DIV/0!,28,82
WESTHPA01 ,1990,1,Paul,Westhead,20,62,0,0,DEN,82,0,24.3902439,#DIV/0!,#DIV/0!,#DIV/0!,20,82
SAUNDFL01 ,2002,1,Flip,Saunders,51,31,2,4,MIN,82,6,62.19512195,33.33333333,47.76422764,0,53,88
FITZSCO01 ,1980,1,Cotton,Fitzsimmons,40,42,7,8,KCK,82,15,48.7804878,46.66666667,47.72357724,0,47,97
CHANEDO01 ,1990,1,Don,Chaney,52,30,0,3,HOU,82,3,63.41463415,0,31.70731707,0,52,85
VERSADI01 ,1990,1,Dick,Versace,9,16,0,0,IND,25,0,36,#DIV/0!,#DIV/0!,#DIV/0!,9,25
WILKELE01 ,1998,1,Lenny,Wilkens,31,19,3,6,ATL,50,9,62,33.33333333,47.66666667,0,34,59
SCHULMI01 ,1990,1,Mike,Schuler,31,51,0,0,LAC,82,0,37.80487805,#DIV/0!,#DIV/0!,#DIV/0!,31,82
SHUEGE01  ,1981,1,Gene,Shue,43,39,3,4,WA1,82,7,52.43902439,42.85714286,47.64808362,0,46,89
ROTHSRO01 ,1990,1,Ron,Rothstein,24,58,0,0,MIA,82,0,29.26829268,#DIV/0!,#DIV/0!,#DIV/0!,24,82
HARRIDE01 ,1990,1,Del,Harris,48,34,0,3,MIL,82,3,58.53658537,0,29.26829268,0,48,85
MUSSEBI01 ,1990,1,Bill,Musselman,29,53,0,0,MIN,82,0,35.36585366,#DIV/0!,#DIV/0!,#DIV/0!,29,82
FITCHBI01 ,1990,1,Bill,Fitch,26,56,0,0,NJN,82,0,31.70731707,#DIV/0!,#DIV/0!,#DIV/0!,26,82
JACKSST01 ,1990,1,Stu,Jackson,7,8,0,0,NYK,15,0,46.66666667,#DIV/0!,#DIV/0!,#DIV/0!,7,15
MACLEJO01 ,1990,2,John,MacLeod,32,35,0,3,NYK,67,3,47.76119403,0,23.88059701,0,32,70
GUOKAMA01 ,1990,1,Matt,Guokas,31,51,0,0,ORL,82,0,37.80487805,#DIV/0!,#DIV/0!,#DIV/0!,31,82
COHALNE01 ,1946,1,Neil,Cohalan,33,27,2,3,NYK,60,5,55,40,47.5,0,35,65
GUOKAMA01 ,1986,1,Matt,Guokas,45,37,2,3,PHI,82,5,54.87804878,40,47.43902439,0,47,87
JACKSST01 ,1989,1,Stu,Jackson,45,37,4,6,NYK,82,10,54.87804878,40,47.43902439,0,49,92
MOTTADI01 ,1990,1,Dick,Motta,25,57,0,0,SAC,82,0,30.48780488,#DIV/0!,#DIV/0!,#DIV/0!,25,82
SAUNDFL01 ,1997,1,Flip,Saunders,45,37,2,3,MIN,82,5,54.87804878,40,47.43902439,0,47,87
WESTPPA01 ,1999,1,Paul,Westphal,45,37,2,3,SEA,82,5,54.87804878,40,47.43902439,0,47,87
MCMILNA01 ,2001,1,Nate,McMillan,45,37,2,3,SEA,82,5,54.87804878,40,47.43902439,0,47,87
UNSELWE01 ,1990,1,Wes,Unseld,30,52,0,0,WA1,82,0,36.58536585,#DIV/0!,#DIV/0!,#DIV/0!,30,82
WEISSBO01 ,1991,1,Bob,Weiss,38,44,0,3,ATL,82,3,46.34146341,0,23.17073171,0,38,85
WESTJE01  ,1978,1,Jerry,West,47,35,3,5,LAL,82,8,57.31707317,37.5,47.40853659,0,50,90
BRISTAL01 ,1991,1,Allan,Bristow,31,51,0,0,CHA,82,0,37.80487805,#DIV/0!,#DIV/0!,#DIV/0!,31,82
UNSELWE01 ,1987,2,Wes,Unseld,30,25,2,3,WA1,55,5,54.54545455,40,47.27272727,0,32,60
KARLGE01  ,1994,1,George,Karl,57,25,1,3,SEA,82,4,69.51219512,25,47.25609756,0,58,86
ADUBARI01 ,1991,1,Richie,Adubato,22,60,0,0,DAL,82,0,26.82926829,#DIV/0!,#DIV/0!,#DIV/0!,22,82
WESTHPA01 ,1991,1,Paul,Westhead,24,58,0,0,DEN,82,0,29.26829268,#DIV/0!,#DIV/0!,#DIV/0!,24,82
BROWNLA01 ,1976,1,Larry,Brown,50,32,2,4,DEN,82,6,60.97560976,33.33333333,47.15447154,0,52,88
RIVERDO01 ,2002,1,Doc,Rivers,42,40,3,4,ORL,82,7,51.2195122,42.85714286,47.03832753,0,45,89
CHANEDO01 ,1991,1,Don,Chaney,26,26,0,0,HOU,52,0,50,#DIV/0!,#DIV/0!,#DIV/0!,26,52
TOMJARU01 ,1991,2,Rudy,Tomjanovich,16,14,0,0,HOU,30,0,53.33333333,#DIV/0!,#DIV/0!,#DIV/0!,16,30
HILLBO01  ,1991,1,Bob,Hill,40,42,0,3,IND,82,3,48.7804878,0,24.3902439,0,40,85
SCHULMI01 ,1991,1,Mike,Schuler,22,25,0,0,LAC,47,0,46.80851064,#DIV/0!,#DIV/0!,#DIV/0!,22,47
AINGEDA01 ,1996,2,Danny,Ainge,40,34,2,3,PHO,74,5,54.05405405,40,47.02702703,0,42,79
ADELMRI01 ,1998,1,Rick,Adelman,27,23,2,3,SAC,50,5,54,40,47,0,29,55
LOUGHKE01 ,1991,1,Kevin,Loughery,38,44,0,3,MIA,82,3,46.34146341,0,23.17073171,0,38,85
HARRIDE01 ,1991,1,Del,Harris,6,9,0,0,MIL,15,0,40,#DIV/0!,#DIV/0!,#DIV/0!,6,15
HAMBLFR01 ,1991,2,Frank,Hamblen,25,42,0,0,MIL,67,0,37.31343284,#DIV/0!,#DIV/0!,#DIV/0!,25,67
RODGEJI01 ,1991,1,Jimmy,Rodgers,15,67,0,0,MIN,82,0,18.29268293,#DIV/0!,#DIV/0!,#DIV/0!,15,82
ROCHAEP01 ,1957,2,Ephraim,Rocha,24,23,3,4,DET,47,7,51.06382979,42.85714286,46.96048632,0,27,54
LOUGHKE01 ,1985,2,Kevin,Loughery,7,6,2,3,WA1,13,5,53.84615385,40,46.92307692,0,9,18
GUOKAMA01 ,1991,1,Matt,Guokas,21,61,0,0,ORL,82,0,25.6097561,#DIV/0!,#DIV/0!,#DIV/0!,21,82
LYNAMJI01 ,1991,1,Jim,Lynam,35,47,0,0,PHI,82,0,42.68292683,#DIV/0!,#DIV/0!,#DIV/0!,35,82
LAYDEFR01 ,1986,1,Frank,Layden,44,38,2,3,UTA,82,5,53.65853659,40,46.82926829,0,46,87
BICKEBE01 ,1987,1,Bernie,Bickerstaff,44,38,2,3,SEA,82,5,53.65853659,40,46.82926829,0,46,87
MOTTADI01 ,1991,1,Dick,Motta,7,18,0,0,SAC,25,0,28,#DIV/0!,#DIV/0!,#DIV/0!,7,25
HUGHERE01 ,1991,2,Rex,Hughes,22,35,0,0,SAC,57,0,38.59649123,#DIV/0!,#DIV/0!,#DIV/0!,22,57
BROWNLA01 ,1991,1,Larry,Brown,21,17,0,0,SAS,38,0,55.26315789,#DIV/0!,#DIV/0!,#DIV/0!,21,38
BASSBO01  ,1991,2,Bob,Bass,26,18,0,3,SAS,44,3,59.09090909,0,29.54545455,0,26,47
JONESKC01 ,1991,1,KC,Jones,18,18,0,0,SEA,36,0,50,#DIV/0!,#DIV/0!,#DIV/0!,18,36
KLOPPBO01 ,1991,2,Bob,Kloppenburg,2,2,0,0,SEA,4,0,50,#DIV/0!,#DIV/0!,#DIV/0!,2,4
CARLEPJ01 ,1995,1,PJ,Carlesimo,44,38,2,3,POR,82,5,53.65853659,40,46.82926829,0,46,87
ADELMRI01 ,1999,1,Rick,Adelman,44,38,2,3,SAC,82,5,53.65853659,40,46.82926829,0,46,87
UNSELWE01 ,1991,1,Wes,Unseld,25,57,0,0,WA1,82,0,30.48780488,#DIV/0!,#DIV/0!,#DIV/0!,25,82
WEISSBO01 ,1992,1,Bob,Weiss,43,39,0,3,ATL,82,3,52.43902439,0,26.2195122,0,43,85
OBRIEJI01 ,2002,1,Jim,O'Brien,44,38,4,6,BOS,82,10,53.65853659,40,46.82926829,0,48,92
BROWNLA01 ,1998,1,Larry,Brown,28,22,3,5,PHI,50,8,56,37.5,46.75,0,31,58
SEYMOPA01 ,1959,1,Paul,Seymour,45,30,1,2,SYR,75,3,60,33.33333333,46.66666667,0,46,78
AINGEDA01 ,1997,1,Danny,Ainge,56,26,1,3,PHO,82,4,68.29268293,25,46.64634146,0,57,86
ADUBARI01 ,1992,1,Richie,Adubato,2,27,0,0,DAL,29,0,6.896551724,#DIV/0!,#DIV/0!,#DIV/0!,2,29
HEARDGA01 ,1992,2,Gar,Heard,9,44,0,0,DAL,53,0,16.98113208,#DIV/0!,#DIV/0!,#DIV/0!,9,53
ISSELDA01 ,1992,1,Dan,Issel,36,46,0,0,DEN,82,0,43.90243902,#DIV/0!,#DIV/0!,#DIV/0!,36,82
ROTHSRO01 ,1992,1,Ron,Rothstein,40,42,0,0,DET,82,0,48.7804878,#DIV/0!,#DIV/0!,#DIV/0!,40,82
NELSODO01 ,1992,1,Don,Nelson,34,48,0,0,GSW,82,0,41.46341463,#DIV/0!,#DIV/0!,#DIV/0!,34,82
AUERBRE01 ,1954,1,Red,Auerbach,36,36,3,4,BOS,72,7,50,42.85714286,46.42857143,0,39,79
FLOYDTI01 ,2003,1,Tim,Floyd,41,41,3,4,NOR,82,7,50,42.85714286,46.42857143,0,44,89
SCHAUFR01 ,1963,1,Fred,Schaus,42,38,2,3,LAL,80,5,52.5,40,46.25,0,44,85
SHARMBI01 ,1967,1,Bill,Sharman,43,39,4,6,SFW,82,10,52.43902439,40,46.2195122,0,47,92
LOUGHKE01 ,1992,1,Kevin,Loughery,36,46,0,0,MIA,82,0,43.90243902,#DIV/0!,#DIV/0!,#DIV/0!,36,82
DUNLEMI01 ,1992,1,Mike,Dunleavy,28,54,0,0,MIL,82,0,34.14634146,#DIV/0!,#DIV/0!,#DIV/0!,28,82
RODGEJI01 ,1992,1,Jimmy,Rodgers,6,23,0,0,MIN,29,0,20.68965517,#DIV/0!,#DIV/0!,#DIV/0!,6,29
LOWESI01  ,1992,2,Sidney,Lowe,13,40,0,0,MIN,53,0,24.52830189,#DIV/0!,#DIV/0!,#DIV/0!,13,53
MOTTADI01 ,1983,1,Dick,Motta,43,39,4,6,DAL,82,10,52.43902439,40,46.2195122,0,47,92
WEISSBO01 ,1990,1,Bob,Weiss,43,39,2,3,ATL,82,5,52.43902439,40,46.2195122,0,45,87
GUOKAMA01 ,1992,1,Matt,Guokas,41,41,0,0,ORL,82,0,50,#DIV/0!,#DIV/0!,#DIV/0!,41,82
MOEDO01   ,1992,1,Doug,Moe,19,37,0,0,PHI,56,0,33.92857143,#DIV/0!,#DIV/0!,#DIV/0!,19,56
CARTEFR01 ,1992,2,Fred,Carter,7,19,0,0,PHI,26,0,26.92307692,#DIV/0!,#DIV/0!,#DIV/0!,7,26
DALYCH01  ,1992,1,Chuck,Daly,43,39,2,3,NJN,82,5,52.43902439,40,46.2195122,0,45,87
VANGUJE01 ,1997,1,Jeff,Van Gundy,43,39,4,6,NYK,82,10,52.43902439,40,46.2195122,0,47,92
STJEAGA01 ,1992,1,Garry,StJean,25,57,0,0,SAC,82,0,30.48780488,#DIV/0!,#DIV/0!,#DIV/0!,25,82
TARKAJE01 ,1992,1,Jerry,Tarkanian,9,11,0,0,SAS,20,0,45,#DIV/0!,#DIV/0!,#DIV/0!,9,20
BROWNLA01 ,2001,1,Larry,Brown,43,39,2,3,PHI,82,5,52.43902439,40,46.2195122,0,45,87
HUGHERE01 ,1992,2,Rex,Hughes,1,0,0,0,SAS,1,0,100,#DIV/0!,#DIV/0!,#DIV/0!,1,1
AUERBRE01 ,1951,1,Red,Auerbach,39,27,1,2,BOS,66,3,59.09090909,33.33333333,46.21212121,0,40,69
MOEDO01   ,1982,1,Doug,Moe,45,37,3,5,DEN,82,8,54.87804878,37.5,46.18902439,0,48,90
UNSELWE01 ,1992,1,Wes,Unseld,22,60,0,0,WA1,82,0,26.82926829,#DIV/0!,#DIV/0!,#DIV/0!,22,82
MOTTADI01 ,1986,1,Dick,Motta,55,27,1,3,DAL,82,4,67.07317073,25,46.03658537,0,56,86
FORDCH01  ,1993,1,Chris,Ford,32,50,0,0,BOS,82,0,39.02439024,#DIV/0!,#DIV/0!,#DIV/0!,32,82
BRISTAL01 ,1993,1,Allan,Bristow,41,41,0,0,CHA,82,0,50,#DIV/0!,#DIV/0!,#DIV/0!,41,82
FITZSCO01 ,1990,1,Cotton,Fitzsimmons,55,27,1,3,PHO,82,4,67.07317073,25,46.03658537,0,56,86
FRATEMI01 ,1993,1,Mike,Fratello,47,35,0,3,CLE,82,3,57.31707317,0,28.65853659,0,47,85
BUCKNQU01 ,1993,1,Quinn,Buckner,13,69,0,0,DAL,82,0,15.85365854,#DIV/0!,#DIV/0!,#DIV/0!,13,82
BROWNLA01 ,1990,1,Larry,Brown,55,27,1,3,SAS,82,4,67.07317073,25,46.03658537,0,56,86
ROTHSRO01 ,1993,1,Ron,Rothstein,20,62,0,0,DET,82,0,24.3902439,#DIV/0!,#DIV/0!,#DIV/0!,20,82
NELSODO01 ,1993,1,Don,Nelson,50,32,0,3,GSW,82,3,60.97560976,0,30.48780488,0,50,85
NELSODO01 ,1991,1,Don,Nelson,55,27,1,3,GSW,82,4,67.07317073,25,46.03658537,0,56,86
LUCASJO01 ,1993,1,John,Lucas,55,27,1,3,SAS,82,4,67.07317073,25,46.03658537,0,56,86
WEISSBO01 ,1993,1,Bob,Weiss,27,55,0,0,LAC,82,0,32.92682927,#DIV/0!,#DIV/0!,#DIV/0!,27,82
PFUNDRA01 ,1993,1,Randy,Pfund,28,39,0,0,LAL,67,0,41.79104478,#DIV/0!,#DIV/0!,#DIV/0!,28,67
JOHNSMA01 ,1993,2,Magic,Johnson,5,10,0,0,LAL,15,0,33.33333333,#DIV/0!,#DIV/0!,#DIV/0!,5,15
KUNDLJO01 ,1958,1,John,Kundla,33,39,6,7,MIE,72,13,45.83333333,46.15384615,45.99358974,0,39,85
DUNLEMI01 ,1993,1,Mike,Dunleavy,20,62,0,0,MIL,82,0,24.3902439,#DIV/0!,#DIV/0!,#DIV/0!,20,82
LOWESI01  ,1993,1,Sidney,Lowe,20,62,0,0,MIN,82,0,24.3902439,#DIV/0!,#DIV/0!,#DIV/0!,20,82
BROWNHE01 ,1975,2,Herb,Brown,19,21,4,5,DET,40,9,47.5,44.44444444,45.97222222,0,23,49
THOMAIS01 ,2002,1,Isiah,Thomas,48,34,2,4,IND,82,6,58.53658537,33.33333333,45.93495935,0,50,88
HILLBR01  ,1993,1,Brian,Hill,50,32,0,3,ORL,82,3,60.97560976,0,30.48780488,0,50,85
CARTEFR01 ,1993,1,Fred,Carter,25,57,0,0,PHI,82,0,30.48780488,#DIV/0!,#DIV/0!,#DIV/0!,25,82
JONESWA01 ,1950,2,Wally,Jones,7,5,1,2,INI,12,3,58.33333333,33.33333333,45.83333333,0,8,15
AUERBRE01 ,1953,1,Red,Auerbach,42,30,2,4,BOS,72,6,58.33333333,33.33333333,45.83333333,0,44,78
STJEAGA01 ,1993,1,Garry,StJean,28,54,0,0,SAC,82,0,34.14634146,#DIV/0!,#DIV/0!,#DIV/0!,28,82
POLLAJI01 ,1959,2,Jim,Pollard,14,25,5,4,MIE,39,9,35.8974359,55.55555556,45.72649573,0,19,48
ECKMACH01 ,1955,1,Charles,Eckman,37,35,4,6,FTW,72,10,51.38888889,40,45.69444444,0,41,82
HANNUAL01 ,1961,1,Alex,Hannum,41,39,2,3,SYR,80,5,51.25,40,45.625,0,43,85
UNSELWE01 ,1993,1,Wes,Unseld,24,58,0,0,WA1,82,0,29.26829268,#DIV/0!,#DIV/0!,#DIV/0!,24,82
WILKELE01 ,1994,1,Lenny,Wilkens,42,40,0,3,ATL,82,3,51.2195122,0,25.6097561,0,42,85
WILKELE01 ,1983,1,Lenny,Wilkens,42,40,2,3,SEA,82,5,51.2195122,40,45.6097561,0,44,87
KARLGE01  ,1986,1,George,Karl,42,40,4,6,GSW,82,10,51.2195122,40,45.6097561,0,46,92
WILKELE01 ,1987,1,Lenny,Wilkens,42,40,2,3,CLE,82,5,51.2195122,40,45.6097561,0,44,87
HARRIDE01 ,1987,1,Del,Harris,42,40,2,3,MIL,82,5,51.2195122,40,45.6097561,0,44,87
MOTTADI01 ,1994,1,Dick,Motta,36,46,0,0,DAL,82,0,43.90243902,#DIV/0!,#DIV/0!,#DIV/0!,36,82
ISSELDA01 ,1994,1,Dan,Issel,18,16,0,0,DEN,34,0,52.94117647,#DIV/0!,#DIV/0!,#DIV/0!,18,34
LITTLGE01 ,1994,2,Gene,Littles,3,13,0,0,DEN,16,0,18.75,#DIV/0!,#DIV/0!,#DIV/0!,3,16
BICKEBE01 ,1994,3,Bernie,Bickerstaff,20,12,0,3,DEN,32,3,62.5,0,31.25,0,20,35
CHANEDO01 ,1994,1,Don,Chaney,28,54,0,0,DET,82,0,34.14634146,#DIV/0!,#DIV/0!,#DIV/0!,28,82
NELSODO01 ,1994,1,Don,Nelson,14,31,0,0,GSW,45,0,31.11111111,#DIV/0!,#DIV/0!,#DIV/0!,14,45
LANIEBO01 ,1994,2,Bob,Lanier,12,25,0,0,GSW,37,0,32.43243243,#DIV/0!,#DIV/0!,#DIV/0!,12,37
WILKELE01 ,1989,1,Lenny,Wilkens,42,40,2,3,CLE,82,5,51.2195122,40,45.6097561,0,44,87
LOUGHKE01 ,1993,1,Kevin,Loughery,42,40,2,3,MIA,82,5,51.2195122,40,45.6097561,0,44,87
FITCHBI01 ,1994,1,Bill,Fitch,17,65,0,0,LAC,82,0,20.73170732,#DIV/0!,#DIV/0!,#DIV/0!,17,82
KARLGE01  ,1999,1,George,Karl,42,40,2,3,MIL,82,5,51.2195122,40,45.6097561,0,44,87
LOUGHKE01 ,1994,1,Kevin,Loughery,17,29,0,0,MIA,46,0,36.95652174,#DIV/0!,#DIV/0!,#DIV/0!,17,46
GENTRAL01 ,1994,2,Alvin,Gentry,15,21,0,0,MIA,36,0,41.66666667,#DIV/0!,#DIV/0!,#DIV/0!,15,36
DUNLEMI01 ,1994,1,Mike,Dunleavy,34,48,0,0,MIL,82,0,41.46341463,#DIV/0!,#DIV/0!,#DIV/0!,34,82
BLAIRBI01 ,1994,1,Bill,Blair,21,61,0,0,MIN,82,0,25.6097561,#DIV/0!,#DIV/0!,#DIV/0!,21,82
BEARDBU01 ,1994,1,Butch,Beard,30,52,0,0,NJN,82,0,36.58536585,#DIV/0!,#DIV/0!,#DIV/0!,30,82
THOMAIS01 ,2001,1,Isiah,Thomas,42,40,2,3,IND,82,5,51.2195122,40,45.6097561,0,44,87
WILKELE01 ,2001,1,Lenny,Wilkens,42,40,2,3,TOR,82,5,51.2195122,40,45.6097561,0,44,87
LUCASJO01 ,1994,1,John,Lucas,24,58,0,0,PHI,82,0,29.26829268,#DIV/0!,#DIV/0!,#DIV/0!,24,82
DALYCH01  ,1998,1,Chuck,Daly,33,17,1,3,ORL,50,4,66,25,45.5,0,34,54
CARLEPJ01 ,1994,1,PJ,Carlesimo,44,38,0,3,POR,82,3,53.65853659,0,26.82926829,0,44,85
STJEAGA01 ,1994,1,Garry,StJean,39,43,0,0,SAC,82,0,47.56097561,#DIV/0!,#DIV/0!,#DIV/0!,39,82
FITZSCO01 ,1979,1,Cotton,Fitzsimmons,47,35,1,2,KCK,82,3,57.31707317,33.33333333,45.32520325,0,48,85
SILASPA01 ,2002,1,Paul,Silas,47,35,2,4,NOH,82,6,57.31707317,33.33333333,45.32520325,0,49,88
SEYMOPA01 ,1957,1,Paul,Seymour,41,31,1,2,SYR,72,3,56.94444444,33.33333333,45.13888889,0,42,75
LYNAMJI01 ,1994,1,Jim,Lynam,21,61,0,0,WA1,82,0,25.6097561,#DIV/0!,#DIV/0!,#DIV/0!,21,82
FITZSCO01 ,1984,1,Cotton,Fitzsimmons,41,41,2,3,SAS,82,5,50,40,45,0,43,87
CARRML01  ,1995,1,ML,Carr,33,49,0,0,BOS,82,0,40.24390244,#DIV/0!,#DIV/0!,#DIV/0!,33,82
BRISTAL01 ,1995,1,Allan,Bristow,41,41,0,0,CHA,82,0,50,#DIV/0!,#DIV/0!,#DIV/0!,41,82
LAYDEFR01 ,1984,1,Frank,Layden,41,41,4,6,UTA,82,10,50,40,45,0,45,92
FRATEMI01 ,1995,1,Mike,Fratello,47,35,0,3,CLE,82,3,57.31707317,0,28.65853659,0,47,85
MOTTADI01 ,1995,1,Dick,Motta,26,56,0,0,DAL,82,0,31.70731707,#DIV/0!,#DIV/0!,#DIV/0!,26,82
BICKEBE01 ,1995,1,Bernie,Bickerstaff,35,47,0,0,DEN,82,0,42.68292683,#DIV/0!,#DIV/0!,#DIV/0!,35,82
COLLIDO01 ,1995,1,Doug,Collins,46,36,0,3,DET,82,3,56.09756098,0,28.04878049,0,46,85
ADELMRI01 ,1995,1,Rick,Adelman,36,46,0,0,GSW,82,0,43.90243902,#DIV/0!,#DIV/0!,#DIV/0!,36,82
JONESKC01 ,1990,1,KC,Jones,41,41,2,3,SEA,82,5,50,40,45,0,43,87
BROWNLA01 ,1992,1,Larry,Brown,41,41,2,3,LAC,82,5,50,40,45,0,43,87
FITCHBI01 ,1995,1,Bill,Fitch,29,53,0,0,LAC,82,0,35.36585366,#DIV/0!,#DIV/0!,#DIV/0!,29,82
TOMJARU01 ,1997,1,Rudy,Tomjanovich,41,41,2,3,HOU,82,5,50,40,45,0,43,87
RILEYPA01 ,1995,1,Pat,Riley,42,40,0,3,MIA,82,3,51.2195122,0,25.6097561,0,42,85
DUNLEMI01 ,1995,1,Mike,Dunleavy,25,57,0,0,MIL,82,0,30.48780488,#DIV/0!,#DIV/0!,#DIV/0!,25,82
BLAIRBI01 ,1995,1,Bill,Blair,6,14,0,0,MIN,20,0,30,#DIV/0!,#DIV/0!,#DIV/0!,6,20
SAUNDFL01 ,1995,2,Flip,Saunders,20,42,0,0,MIN,62,0,32.25806452,#DIV/0!,#DIV/0!,#DIV/0!,20,62
BEARDBU01 ,1995,1,Butch,Beard,30,52,0,0,NJN,82,0,36.58536585,#DIV/0!,#DIV/0!,#DIV/0!,30,82
NELSODO01 ,1995,1,Don,Nelson,34,25,0,0,NYK,59,0,57.62711864,#DIV/0!,#DIV/0!,#DIV/0!,34,59
CLIFFRO01 ,1946,2,Roy,Clifford,13,10,1,2,CL1,23,3,56.52173913,33.33333333,44.92753623,0,14,26
SCHULMI01 ,1987,1,Mike,Schuler,53,29,1,3,POR,82,4,64.63414634,25,44.81707317,0,54,86
LUCASJO01 ,1995,1,John,Lucas,18,64,0,0,PHI,82,0,21.95121951,#DIV/0!,#DIV/0!,#DIV/0!,18,82
WESTPPA01 ,1995,1,Paul,Westphal,14,19,0,0,PHO,33,0,42.42424242,#DIV/0!,#DIV/0!,#DIV/0!,14,33
HARRIDE01 ,1995,1,Del,Harris,53,29,1,3,LAL,82,4,64.63414634,25,44.81707317,0,54,86
POPOVGR01 ,1999,1,Gregg,Popovich,53,29,1,3,SAS,82,4,64.63414634,25,44.81707317,0,54,86
FITZSCO01 ,1972,1,Cotton,Fitzsimmons,46,36,2,4,ATL,82,6,56.09756098,33.33333333,44.71544715,0,48,88
SHUEGE01  ,1975,1,Gene,Shue,46,36,1,2,PHI,82,3,56.09756098,33.33333333,44.71544715,0,47,85
MOEDO01   ,1981,1,Doug,Moe,46,36,1,2,DEN,82,3,56.09756098,33.33333333,44.71544715,0,47,85
MALONBR01 ,1995,1,Brendan,Malone,21,61,0,0,TOR,82,0,25.6097561,#DIV/0!,#DIV/0!,#DIV/0!,21,82
HARRIDE01 ,1981,1,Del,Harris,46,36,1,2,HOU,82,3,56.09756098,33.33333333,44.71544715,0,47,85
WINTEBR01 ,1995,1,Brian,Winters,15,67,0,0,VAN,82,0,18.29268293,#DIV/0!,#DIV/0!,#DIV/0!,15,82
LYNAMJI01 ,1995,1,Jim,Lynam,39,43,0,0,WA1,82,0,47.56097561,#DIV/0!,#DIV/0!,#DIV/0!,39,82
SENESGE01 ,1957,1,George,Senesky,37,35,3,5,PH1,72,8,51.38888889,37.5,44.44444444,0,40,80
CARRML01  ,1996,1,ML,Carr,15,67,0,0,BOS,82,0,18.29268293,#DIV/0!,#DIV/0!,#DIV/0!,15,82
COWENDA01 ,1996,1,Dave,Cowens,54,28,0,3,CHA,82,3,65.85365854,0,32.92682927,0,54,85
FRATEMI01 ,1983,1,Mike,Fratello,40,42,2,3,ATL,82,5,48.7804878,40,44.3902439,0,42,87
FRATEMI01 ,1996,1,Mike,Fratello,42,40,0,0,CLE,82,0,51.2195122,#DIV/0!,#DIV/0!,#DIV/0!,42,82
CLEAMJI01 ,1996,1,Jim,Cleamons,24,58,0,0,DAL,82,0,29.26829268,#DIV/0!,#DIV/0!,#DIV/0!,24,82
BICKEBE01 ,1996,1,Bernie,Bickerstaff,4,9,0,0,DEN,13,0,30.76923077,#DIV/0!,#DIV/0!,#DIV/0!,4,13
MOTTADI01 ,1996,2,Dick,Motta,17,52,0,0,DEN,69,0,24.63768116,#DIV/0!,#DIV/0!,#DIV/0!,17,69
SCHAYDO01 ,1965,1,Dolph,Schayes,55,25,1,4,PHI,80,5,68.75,20,44.375,0,56,85
ADELMRI01 ,1996,1,Rick,Adelman,30,52,0,0,GSW,82,0,36.58536585,#DIV/0!,#DIV/0!,#DIV/0!,30,82
REEDWI01  ,1978,1,Willis,Reed,6,8,10,12,NYK,14,22,42.85714286,45.45454545,44.15584416,0,16,36
BROWNLA01 ,1996,1,Larry,Brown,39,43,0,0,IND,82,0,47.56097561,#DIV/0!,#DIV/0!,#DIV/0!,39,82
FITCHBI01 ,1996,1,Bill,Fitch,36,46,0,3,LAC,82,3,43.90243902,0,21.95121951,0,36,85
WESTJE01  ,1977,1,Jerry,West,45,37,1,2,LAL,82,3,54.87804878,33.33333333,44.10569106,0,46,85
RAMSAJA01 ,1978,1,Jack,Ramsay,45,37,1,2,POR,82,3,54.87804878,33.33333333,44.10569106,0,46,85
FORDCH01  ,1996,1,Chris,Ford,33,49,0,0,MIL,82,0,40.24390244,#DIV/0!,#DIV/0!,#DIV/0!,33,82
SAUNDFL01 ,1996,1,Flip,Saunders,40,42,0,3,MIN,82,3,48.7804878,0,24.3902439,0,40,85
CALIPJO01 ,1996,1,John,Calipari,26,56,0,0,NJN,82,0,31.70731707,#DIV/0!,#DIV/0!,#DIV/0!,26,82
SLOANJE01 ,1980,1,Jerry,Sloan,45,37,2,4,CHI,82,6,54.87804878,33.33333333,44.10569106,0,47,88
HILLBR01  ,1996,1,Brian,Hill,24,25,0,0,ORL,49,0,48.97959184,#DIV/0!,#DIV/0!,#DIV/0!,24,49
RAMSAJA01 ,1980,1,Jack,Ramsay,45,37,1,2,POR,82,3,54.87804878,33.33333333,44.10569106,0,46,85
DAVISJO01 ,1996,1,Johnny,Davis,22,60,0,0,PHI,82,0,26.82926829,#DIV/0!,#DIV/0!,#DIV/0!,22,82
FITZSCO01 ,1996,1,Cotton,Fitzsimmons,0,8,0,0,PHO,8,0,0,#DIV/0!,#DIV/0!,#DIV/0!,0,8
PFUNDRA01 ,1992,1,Randy,Pfund,39,43,2,3,LAL,82,5,47.56097561,40,43.7804878,0,41,87
LAPCHJO01 ,1947,1,Joe,Lapchick,26,22,1,2,NYK,48,3,54.16666667,33.33333333,43.75,0,27,51
STJEAGA01 ,1996,1,Garry,StJean,28,39,0,0,SAC,67,0,41.79104478,#DIV/0!,#DIV/0!,#DIV/0!,28,67
JORDAED01 ,1996,2,Eddie,Jordan,6,9,0,0,SAC,15,0,40,#DIV/0!,#DIV/0!,#DIV/0!,6,15
HILLBO01  ,1996,1,Bob,Hill,3,15,0,0,SAS,18,0,16.66666667,#DIV/0!,#DIV/0!,#DIV/0!,3,18
POPOVGR01 ,1996,2,Gregg,Popovich,17,47,0,0,SAS,64,0,26.5625,#DIV/0!,#DIV/0!,#DIV/0!,17,64
AUERBRE01 ,1955,1,Red,Auerbach,39,33,1,2,BOS,72,3,54.16666667,33.33333333,43.75,0,40,75
WALKEDA01 ,1996,1,Darrell,Walker,30,52,0,0,TOR,82,0,36.58536585,#DIV/0!,#DIV/0!,#DIV/0!,30,82
EGANJO01  ,1974,1,John,Egan,41,41,3,5,HOU,82,8,50,37.5,43.75,0,44,90
WINTEBR01 ,1996,1,Brian,Winters,8,35,0,0,VAN,43,0,18.60465116,#DIV/0!,#DIV/0!,#DIV/0!,8,43
JACKSST01 ,1996,2,Stu,Jackson,6,33,0,0,VAN,39,0,15.38461538,#DIV/0!,#DIV/0!,#DIV/0!,6,39
LYNAMJI01 ,1996,1,Jim,Lynam,22,24,0,0,WA1,46,0,47.82608696,#DIV/0!,#DIV/0!,#DIV/0!,22,46
BICKEBE01 ,1996,2,Bernie,Bickerstaff,22,14,0,3,WA1,36,3,61.11111111,0,30.55555556,0,22,39
KUNDLJO01 ,1956,1,John,Kundla,34,38,2,3,MIE,72,5,47.22222222,40,43.61111111,0,36,77
PITINRI01 ,1997,1,Rick,Pitino,36,46,0,0,BOS,82,0,43.90243902,#DIV/0!,#DIV/0!,#DIV/0!,36,82
ADELMRI01 ,1992,1,Rick,Adelman,51,31,1,3,POR,82,4,62.19512195,25,43.59756098,0,52,86
SKILESC01 ,2000,1,Scott,Skiles,51,31,1,3,PHO,82,4,62.19512195,25,43.59756098,0,52,86
RAMSAJA01 ,1968,1,Jack,Ramsay,55,27,1,4,PHI,82,5,67.07317073,20,43.53658537,0,56,87
CLEAMJI01 ,1997,1,Jim,Cleamons,4,12,0,0,DAL,16,0,25,#DIV/0!,#DIV/0!,#DIV/0!,4,16
NELSODO01 ,1997,2,Don,Nelson,16,50,0,0,DAL,66,0,24.24242424,#DIV/0!,#DIV/0!,#DIV/0!,16,66
HANZLBI01 ,1997,1,Bill,Hanzlik,11,71,0,0,DEN,82,0,13.41463415,#DIV/0!,#DIV/0!,#DIV/0!,11,82
COLLIDO01 ,1997,1,Doug,Collins,21,24,0,0,DET,45,0,46.66666667,#DIV/0!,#DIV/0!,#DIV/0!,21,45
GENTRAL01 ,1997,2,Alvin,Gentry,16,21,0,0,DET,37,0,43.24324324,#DIV/0!,#DIV/0!,#DIV/0!,16,37
CARLEPJ01 ,1997,1,PJ,Carlesimo,19,63,0,0,GSW,82,0,23.17073171,#DIV/0!,#DIV/0!,#DIV/0!,19,82
TOMJARU01 ,1998,1,Rudy,Tomjanovich,31,19,1,3,HOU,50,4,62,25,43.5,0,32,54
JOHNSPH01 ,1974,1,Phil,Johnson,44,38,2,4,KCK,82,6,53.65853659,33.33333333,43.49593496,0,46,88
FITCHBI01 ,1997,1,Bill,Fitch,17,65,0,0,LAC,82,0,20.73170732,#DIV/0!,#DIV/0!,#DIV/0!,17,82
BADGEED01 ,1976,1,Ed,Badger,44,38,1,2,CHI,82,3,53.65853659,33.33333333,43.49593496,0,45,85
BROWNHE01 ,1976,1,Herb,Brown,44,38,1,2,DET,82,3,53.65853659,33.33333333,43.49593496,0,45,85
FORDCH01  ,1997,1,Chris,Ford,36,46,0,0,MIL,82,0,43.90243902,#DIV/0!,#DIV/0!,#DIV/0!,36,82
BROWNHU01 ,1982,1,Hubie,Brown,44,38,2,4,NYK,82,6,53.65853659,33.33333333,43.49593496,0,46,88
CALIPJO01 ,1997,1,John,Calipari,43,39,0,3,NJN,82,3,52.43902439,0,26.2195122,0,43,85
JOHNSFR01 ,2002,1,Frank,Johnson,44,38,2,4,PHO,82,6,53.65853659,33.33333333,43.49593496,0,46,88
DALYCH01  ,1997,1,Chuck,Daly,41,41,0,0,ORL,82,0,50,#DIV/0!,#DIV/0!,#DIV/0!,41,82
BROWNLA01 ,1997,1,Larry,Brown,31,51,0,0,PHI,82,0,37.80487805,#DIV/0!,#DIV/0!,#DIV/0!,31,82
MOEDO01   ,1983,1,Doug,Moe,38,44,2,3,DEN,82,5,46.34146341,40,43.17073171,0,40,87
LAPCHJO01 ,1954,1,Joe,Lapchick,38,34,1,2,NYK,72,3,52.77777778,33.33333333,43.05555556,0,39,75
JORDAED01 ,1997,1,Eddie,Jordan,27,55,0,0,SAC,82,0,32.92682927,#DIV/0!,#DIV/0!,#DIV/0!,27,82
BRISTAL01 ,1994,1,Allan,Bristow,50,32,1,3,CHA,82,4,60.97560976,25,42.98780488,0,51,86
WILKELE01 ,1997,1,Lenny,Wilkens,50,32,1,3,ATL,82,4,60.97560976,25,42.98780488,0,51,86
WALKEDA01 ,1997,1,Darrell,Walker,11,38,0,0,TOR,49,0,22.44897959,#DIV/0!,#DIV/0!,#DIV/0!,11,49
CARTEBU01 ,1997,2,Butch,Carter,5,28,0,0,TOR,33,0,15.15151515,#DIV/0!,#DIV/0!,#DIV/0!,5,33
SAUNDFL01 ,1999,1,Flip,Saunders,50,32,1,3,MIN,82,4,60.97560976,25,42.98780488,0,51,86
HILLBR01  ,1997,1,Brian,Hill,19,63,0,0,VAN,82,0,23.17073171,#DIV/0!,#DIV/0!,#DIV/0!,19,82
BICKEBE01 ,1997,1,Bernie,Bickerstaff,42,40,0,0,WAS,82,0,51.2195122,#DIV/0!,#DIV/0!,#DIV/0!,42,82
RUSSEBI01 ,1975,1,Bill,Russell,43,39,2,4,SEA,82,6,52.43902439,33.33333333,42.88617886,0,45,88
PITINRI01 ,1998,1,Rick,Pitino,19,31,0,0,BOS,50,0,38,#DIV/0!,#DIV/0!,#DIV/0!,19,50
COWENDA01 ,1998,1,Dave,Cowens,4,11,0,0,CHA,15,0,26.66666667,#DIV/0!,#DIV/0!,#DIV/0!,4,15
SILASPA01 ,1998,1,Paul,Silas,22,13,0,0,CHA,35,0,62.85714286,#DIV/0!,#DIV/0!,#DIV/0!,22,35
FLOYDTI01 ,1998,1,Tim,Floyd,13,37,0,0,CHI,50,0,26,#DIV/0!,#DIV/0!,#DIV/0!,13,50
FRATEMI01 ,1998,1,Mike,Fratello,22,28,0,0,CLE,50,0,44,#DIV/0!,#DIV/0!,#DIV/0!,22,50
NELSODO01 ,1998,1,Don,Nelson,19,31,0,0,DAL,50,0,38,#DIV/0!,#DIV/0!,#DIV/0!,19,50
DANTOMI01 ,1998,1,Mike,D'Antoni,14,36,0,0,DEN,50,0,28,#DIV/0!,#DIV/0!,#DIV/0!,14,50
FITCHBI01 ,1976,1,Bill,Fitch,43,39,1,2,CLE,82,3,52.43902439,33.33333333,42.88617886,0,44,85
CARLEPJ01 ,1998,1,PJ,Carlesimo,21,29,0,0,GSW,50,0,42,#DIV/0!,#DIV/0!,#DIV/0!,21,50
REEDWI01  ,1977,1,Willis,Reed,43,39,2,4,NYK,82,6,52.43902439,33.33333333,42.88617886,0,45,88
LOUGHKE01 ,1982,1,Kevin,Loughery,43,39,1,2,ATL,82,3,52.43902439,33.33333333,42.88617886,0,44,85
FORDCH01  ,1998,1,Chris,Ford,9,41,0,0,LAC,50,0,18,#DIV/0!,#DIV/0!,#DIV/0!,9,50
HARRIDE01 ,1998,1,Del,Harris,6,6,0,0,LAL,12,0,50,#DIV/0!,#DIV/0!,#DIV/0!,6,12
BERTKBI01 ,1998,2,Bill,Bertka,1,0,0,0,LAL,1,0,100,#DIV/0!,#DIV/0!,#DIV/0!,1,1
MCMAHJA01 ,1964,1,Jack,McMahon,48,32,1,3,CIN,80,4,60,25,42.5,0,49,84
SCHULMI01 ,1986,1,Mike,Schuler,49,33,1,3,POR,82,4,59.75609756,25,42.37804878,0,50,86
KARLGE01  ,1998,1,George,Karl,28,22,0,3,MIL,50,3,56,0,28,0,28,53
CARLEPJ01 ,1996,1,PJ,Carlesimo,49,33,1,3,POR,82,4,59.75609756,25,42.37804878,0,50,86
CALIPJO01 ,1998,1,John,Calipari,3,17,0,0,NJN,20,0,15,#DIV/0!,#DIV/0!,#DIV/0!,3,20
CASEYDO01 ,1998,2,Don,Casey,13,17,0,0,NJN,30,0,43.33333333,#DIV/0!,#DIV/0!,#DIV/0!,13,30
SILASPA01 ,1999,1,Paul,Silas,49,33,1,3,CHA,82,4,59.75609756,25,42.37804878,0,50,86
MACLEJO01 ,1981,1,John,MacLeod,46,36,2,5,PHO,82,7,56.09756098,28.57142857,42.33449477,0,48,89
GUERIRI01 ,1964,2,Richie,Guerin,28,19,1,3,STL,47,4,59.57446809,25,42.28723404,0,29,51
AINGEDA01 ,1998,1,Danny,Ainge,27,23,0,3,PHO,50,3,54,0,27,0,27,53
RAMSAJA01 ,1973,1,Jack,Ramsay,42,40,2,4,BUF,82,6,51.2195122,33.33333333,42.27642276,0,44,88
KARLGE01  ,2002,1,George,Karl,42,40,2,4,MIL,82,6,51.2195122,33.33333333,42.27642276,0,44,88
FORDCH01  ,1992,1,Chris,Ford,48,34,1,3,BOS,82,4,58.53658537,25,41.76829268,0,49,86
WESTPPA01 ,1998,1,Paul,Westphal,25,25,0,0,SEA,50,0,50,#DIV/0!,#DIV/0!,#DIV/0!,25,50
CARTEBU01 ,1998,1,Butch,Carter,23,27,0,0,TOR,50,0,46,#DIV/0!,#DIV/0!,#DIV/0!,23,50
SHUEGE01  ,1972,1,Gene,Shue,52,30,1,4,BAL,82,5,63.41463415,20,41.70731707,0,53,87
HILLBR01  ,1998,1,Brian,Hill,8,42,0,0,VAN,50,0,16,#DIV/0!,#DIV/0!,#DIV/0!,8,50
BICKEBE01 ,1998,1,Bernie,Bickerstaff,13,19,0,0,WAS,32,0,40.625,#DIV/0!,#DIV/0!,#DIV/0!,13,32
BROVEJI01 ,1998,2,Jim,Brovelli,5,13,0,0,WAS,18,0,27.77777778,#DIV/0!,#DIV/0!,#DIV/0!,5,18
WILKELE01 ,1999,1,Lenny,Wilkens,28,54,0,0,ATL,82,0,34.14634146,#DIV/0!,#DIV/0!,#DIV/0!,28,82
PITINRI01 ,1999,1,Rick,Pitino,35,47,0,0,BOS,82,0,42.68292683,#DIV/0!,#DIV/0!,#DIV/0!,35,82
NELSODO01 ,2003,1,Don,Nelson,52,30,1,4,DAL,82,5,63.41463415,20,41.70731707,0,53,87
FLOYDTI01 ,1999,1,Tim,Floyd,17,65,0,0,CHI,82,0,20.73170732,#DIV/0!,#DIV/0!,#DIV/0!,17,82
WITTMRA01 ,1999,1,Randy,Wittman,32,50,0,0,CLE,82,0,39.02439024,#DIV/0!,#DIV/0!,#DIV/0!,32,82
NELSODO01 ,1999,1,Don,Nelson,40,42,0,0,DAL,82,0,48.7804878,#DIV/0!,#DIV/0!,#DIV/0!,40,82
ISSELDA01 ,1999,1,Dan,Issel,35,47,0,0,DEN,82,0,42.68292683,#DIV/0!,#DIV/0!,#DIV/0!,35,82
GENTRAL01 ,1999,1,Alvin,Gentry,28,30,0,0,DET,58,0,48.27586207,#DIV/0!,#DIV/0!,#DIV/0!,28,58
IRVINGE01 ,1999,2,George,Irvine,14,10,0,3,DET,24,3,58.33333333,0,29.16666667,0,14,27
CARLEPJ01 ,1999,1,PJ,Carlesimo,6,21,0,0,GSW,27,0,22.22222222,#DIV/0!,#DIV/0!,#DIV/0!,6,27
STJEAGA01 ,1999,2,Garry,StJean,13,42,0,0,GSW,55,0,23.63636364,#DIV/0!,#DIV/0!,#DIV/0!,13,55
TOMJARU01 ,1999,1,Rudy,Tomjanovich,34,48,0,0,HOU,82,0,41.46341463,#DIV/0!,#DIV/0!,#DIV/0!,34,82
GOTTLED01 ,1951,1,Eddie,Gottlieb,33,33,1,2,PH1,66,3,50,33.33333333,41.66666667,0,34,69
FORDCH01  ,1999,1,Chris,Ford,11,34,0,0,LAC,45,0,24.44444444,#DIV/0!,#DIV/0!,#DIV/0!,11,45
TODDJI01  ,1999,2,Jim,Todd,4,33,0,0,LAC,37,0,10.81081081,#DIV/0!,#DIV/0!,#DIV/0!,4,37
LEEGE01   ,1968,1,George,Lee,41,41,2,4,SFW,82,6,50,33.33333333,41.66666667,0,43,88
BASSBO01  ,1979,2,Bob,Bass,8,8,1,2,SAS,16,3,50,33.33333333,41.66666667,0,9,19
MCGUIDI01 ,1960,1,Dick,McGuire,34,45,2,3,DET,79,5,43.03797468,40,41.51898734,0,36,84
SCHAYDO01 ,1963,1,Dolph,Schayes,34,46,2,3,PHI,80,5,42.5,40,41.25,0,36,85
CASEYDO01 ,1999,1,Don,Casey,31,51,0,0,NJN,82,0,37.80487805,#DIV/0!,#DIV/0!,#DIV/0!,31,82
AUERBRE01 ,1949,1,Red,Auerbach,28,29,1,2,TRI,57,3,49.12280702,33.33333333,41.22807018,0,29,60
RIVERDO01 ,1999,1,Doc,Rivers,41,41,0,0,ORL,82,0,50,#DIV/0!,#DIV/0!,#DIV/0!,41,82
ADELMRI01 ,1993,1,Rick,Adelman,47,35,1,3,POR,82,4,57.31707317,25,41.15853659,0,48,86
AINGEDA01 ,1999,1,Danny,Ainge,13,7,0,0,PHO,20,0,65,#DIV/0!,#DIV/0!,#DIV/0!,13,20
FRATEMI01 ,1997,1,Mike,Fratello,47,35,1,3,CLE,82,4,57.31707317,25,41.15853659,0,48,86
SAUNDFL01 ,2000,1,Flip,Saunders,47,35,1,3,MIN,82,4,57.31707317,25,41.15853659,0,48,86
ATTLEAL01 ,1971,1,Al,Attles,51,31,1,4,GSW,82,5,62.19512195,20,41.09756098,0,52,87
BUTCHDO01 ,1967,1,Donnis,Butcher,40,42,2,4,DET,82,6,48.7804878,33.33333333,41.05691057,0,42,88
SCOTTRA01 ,1974,1,Ray,Scott,40,42,1,2,DET,82,3,48.7804878,33.33333333,41.05691057,0,41,85
CARTEBU01 ,1999,1,Butch,Carter,45,37,0,3,TOR,82,3,54.87804878,0,27.43902439,0,45,85
HOLZMRE01 ,1974,1,Red,Holzman,40,42,1,2,NYK,82,3,48.7804878,33.33333333,41.05691057,0,41,85
HILLBR01  ,1999,1,Brian,Hill,4,18,0,0,VAN,22,0,18.18181818,#DIV/0!,#DIV/0!,#DIV/0!,4,22
HOLLILI01 ,1999,2,Lionel,Hollins,18,42,0,0,VAN,60,0,30,#DIV/0!,#DIV/0!,#DIV/0!,18,60
WALKEDA01 ,1999,1,Darrell,Walker,15,23,0,0,WAS,38,0,39.47368421,#DIV/0!,#DIV/0!,#DIV/0!,15,38
HEARDGA01 ,1999,2,Gar,Heard,14,30,0,0,WAS,44,0,31.81818182,#DIV/0!,#DIV/0!,#DIV/0!,14,44
KRUGELO01 ,2000,1,Lon,Kruger,25,57,0,0,ATL,82,0,30.48780488,#DIV/0!,#DIV/0!,#DIV/0!,25,82
PITINRI01 ,2000,1,Rick,Pitino,12,22,0,0,BOS,34,0,35.29411765,#DIV/0!,#DIV/0!,#DIV/0!,12,34
OBRIEJI01 ,2000,2,Jim,O'Brien,24,24,0,0,BOS,48,0,50,#DIV/0!,#DIV/0!,#DIV/0!,24,48
JEANNBU01 ,1948,1,Buddy,Jeannette,29,31,1,2,BA1,60,3,48.33333333,33.33333333,40.83333333,0,30,63
FLOYDTI01 ,2000,1,Tim,Floyd,15,67,0,0,CHI,82,0,18.29268293,#DIV/0!,#DIV/0!,#DIV/0!,15,82
WITTMRA01 ,2000,1,Randy,Wittman,30,52,0,0,CLE,82,0,36.58536585,#DIV/0!,#DIV/0!,#DIV/0!,30,82
DALYCH01  ,1985,1,Chuck,Daly,46,36,1,3,DET,82,4,56.09756098,25,40.54878049,0,47,86
NELSODO02 ,2000,2,Donn,Nelson,13,8,0,0,DAL,21,0,61.9047619,#DIV/0!,#DIV/0!,#DIV/0!,13,21
ISSELDA01 ,2000,1,Dan,Issel,40,42,0,0,DEN,82,0,48.7804878,#DIV/0!,#DIV/0!,#DIV/0!,40,82
IRVINGE01 ,2000,1,George,Irvine,32,50,0,0,DET,82,0,39.02439024,#DIV/0!,#DIV/0!,#DIV/0!,32,82
COWENDA01 ,2000,1,Dave,Cowens,17,65,0,0,GSW,82,0,20.73170732,#DIV/0!,#DIV/0!,#DIV/0!,17,82
TOMJARU01 ,2000,1,Rudy,Tomjanovich,45,37,0,0,HOU,82,0,54.87804878,#DIV/0!,#DIV/0!,#DIV/0!,45,82
FITCHBI01 ,1987,1,Bill,Fitch,46,36,1,3,HOU,82,4,56.09756098,25,40.54878049,0,47,86
GENTRAL01 ,2000,1,Alvin,Gentry,31,51,0,0,LAC,82,0,37.80487805,#DIV/0!,#DIV/0!,#DIV/0!,31,82
DUNLEMI01 ,1997,1,Mike,Dunleavy,46,36,1,3,POR,82,4,56.09756098,25,40.54878049,0,47,86
RILEYPA01 ,2000,1,Pat,Riley,50,32,0,3,MIA,82,3,60.97560976,0,30.48780488,0,50,85
BROWNHU01 ,1979,1,Hubie,Brown,50,32,1,4,ATL,82,5,60.97560976,20,40.48780488,0,51,87
MENDEMU01 ,1950,1,Murray,Mendenhall,32,36,1,2,DET,68,3,47.05882353,33.33333333,40.19607843,0,33,71
SCOTTBY01 ,2000,1,Byron,Scott,26,56,0,0,NJN,82,0,31.70731707,#DIV/0!,#DIV/0!,#DIV/0!,26,82
FITZSCO01 ,1995,2,Cotton,Fitzsimmons,27,22,1,3,PHO,49,4,55.10204082,25,40.05102041,0,28,53
CHANEDO01 ,1988,1,Don,Chaney,45,37,1,3,HOU,82,4,54.87804878,25,39.93902439,0,46,86
DALYCH01  ,1993,1,Chuck,Daly,45,37,1,3,NJN,82,4,54.87804878,25,39.93902439,0,46,86
SHUEGE01  ,1971,1,Gene,Shue,38,44,2,4,BAL,82,6,46.34146341,33.33333333,39.83739837,0,40,88
DUNLEMI01 ,2000,1,Mike,Dunleavy,50,32,0,3,POR,82,3,60.97560976,0,30.48780488,0,50,85
COSTELA01 ,1975,1,Larry,Costello,38,44,1,2,MIL,82,3,46.34146341,33.33333333,39.83739837,0,39,85
RAMSAJA01 ,1979,1,Jack,Ramsay,38,44,1,2,POR,82,3,46.34146341,33.33333333,39.83739837,0,39,85
WESTPPA01 ,2000,1,Paul,Westphal,6,9,0,0,SEA,15,0,40,#DIV/0!,#DIV/0!,#DIV/0!,6,15
MCMILNA01 ,2000,2,Nate,McMillan,38,29,0,0,SEA,67,0,56.71641791,#DIV/0!,#DIV/0!,#DIV/0!,38,67
KUNDLJO01 ,1955,1,John,Kundla,33,39,1,2,MIE,72,3,45.83333333,33.33333333,39.58333333,0,34,75
WOLFCH01  ,1961,1,Charles,Wolf,43,37,1,3,CIN,80,4,53.75,25,39.375,0,44,84
LOWESI01  ,2000,1,Sidney,Lowe,23,59,0,0,VAN,82,0,28.04878049,#DIV/0!,#DIV/0!,#DIV/0!,23,82
HAMILLE01 ,2000,1,Leonard,Hamilton,19,63,0,0,WAS,82,0,23.17073171,#DIV/0!,#DIV/0!,#DIV/0!,19,82
KRUGELO01 ,2001,1,Lon,Kruger,33,49,0,0,ATL,82,0,40.24390244,#DIV/0!,#DIV/0!,#DIV/0!,33,82
MOTTADI01 ,1984,1,Dick,Motta,44,38,1,3,DAL,82,4,53.65853659,25,39.32926829,0,45,86
HARRIDE01 ,1989,1,Del,Harris,44,38,1,3,MIL,82,4,53.65853659,25,39.32926829,0,45,86
FLOYDTI01 ,2001,1,Tim,Floyd,4,21,0,0,CHI,25,0,16,#DIV/0!,#DIV/0!,#DIV/0!,4,25
BERRYBI01 ,2001,2,Bill,Berry,0,2,0,0,CHI,2,0,0,#DIV/0!,#DIV/0!,#DIV/0!,0,2
CARTWBI01 ,2001,3,Bill,Cartwright,17,38,0,0,CHI,55,0,30.90909091,#DIV/0!,#DIV/0!,#DIV/0!,17,55
LUCASJO01 ,2001,1,John,Lucas,29,53,0,0,CLE,82,0,35.36585366,#DIV/0!,#DIV/0!,#DIV/0!,29,82
RIVERDO01 ,2001,1,Doc,Rivers,44,38,1,3,ORL,82,4,53.65853659,25,39.32926829,0,45,86
ISSELDA01 ,2001,1,Dan,Issel,9,17,0,0,DEN,26,0,34.61538462,#DIV/0!,#DIV/0!,#DIV/0!,9,26
EVANSMI01 ,2001,2,Mike,Evans,18,38,0,0,DEN,56,0,32.14285714,#DIV/0!,#DIV/0!,#DIV/0!,18,56
SLOANJE01 ,2001,1,Jerry,Sloan,44,38,1,3,UTA,82,4,53.65853659,25,39.32926829,0,45,86
COWENDA01 ,2001,1,Dave,Cowens,8,15,0,0,GSW,23,0,34.7826087,#DIV/0!,#DIV/0!,#DIV/0!,8,23
WINTEBR01 ,2001,2,Brian,Winters,13,46,0,0,GSW,59,0,22.03389831,#DIV/0!,#DIV/0!,#DIV/0!,13,59
TOMJARU01 ,2001,1,Rudy,Tomjanovich,28,54,0,0,HOU,82,0,34.14634146,#DIV/0!,#DIV/0!,#DIV/0!,28,82
HARRIDE01 ,1979,1,Del,Harris,41,41,2,5,HOU,82,7,50,28.57142857,39.28571429,0,43,89
GENTRAL01 ,2001,1,Alvin,Gentry,39,43,0,0,LAC,82,0,47.56097561,#DIV/0!,#DIV/0!,#DIV/0!,39,82
FITZSCO01 ,1978,1,Cotton,Fitzsimmons,48,34,1,4,KCK,82,5,58.53658537,20,39.26829268,0,49,87
LOWESI01  ,2001,1,Sidney,Lowe,23,59,0,0,MEM,82,0,28.04878049,#DIV/0!,#DIV/0!,#DIV/0!,23,82
RILEYPA01 ,2001,1,Pat,Riley,36,46,0,0,MIA,82,0,43.90243902,#DIV/0!,#DIV/0!,#DIV/0!,36,82
KARLGE01  ,2001,1,George,Karl,41,41,0,0,MIL,82,0,50,#DIV/0!,#DIV/0!,#DIV/0!,41,82
SAUNDFL01 ,2001,1,Flip,Saunders,50,32,0,3,MIN,82,3,60.97560976,0,30.48780488,0,50,85
MCMAHJA01 ,1968,1,Jack,McMahon,37,45,2,4,SDR,82,6,45.12195122,33.33333333,39.22764228,0,39,88
VANGUJE01 ,2001,1,Jeff,Van Gundy,10,9,0,0,NYK,19,0,52.63157895,#DIV/0!,#DIV/0!,#DIV/0!,10,19
CHANEDO01 ,2001,2,Don,Chaney,20,43,0,0,NYK,63,0,31.74603175,#DIV/0!,#DIV/0!,#DIV/0!,20,63
DUNLEMI01 ,1991,1,Mike,Dunleavy,43,39,1,3,LAL,82,4,52.43902439,25,38.7195122,0,44,86
FRATEMI01 ,1994,1,Mike,Fratello,43,39,1,3,CLE,82,4,52.43902439,25,38.7195122,0,44,86
SKILESC01 ,2001,1,Scott,Skiles,25,26,0,0,PHO,51,0,49.01960784,#DIV/0!,#DIV/0!,#DIV/0!,25,51
JOHNSFR01 ,2001,2,Frank,Johnson,11,20,0,0,PHO,31,0,35.48387097,#DIV/0!,#DIV/0!,#DIV/0!,11,31
CHEEKMA01 ,2001,1,Maurice,Cheeks,49,33,0,3,POR,82,3,59.75609756,0,29.87804878,0,49,85
RIVERDO01 ,2000,1,Doc,Rivers,43,39,1,3,ORL,82,4,52.43902439,25,38.7195122,0,44,86
SHARMBI01 ,1973,1,Bill,Sharman,47,35,1,4,LAL,82,5,57.31707317,20,38.65853659,0,48,87
SLOANJE01 ,2002,1,Jerry,Sloan,47,35,1,4,UTA,82,5,57.31707317,20,38.65853659,0,48,87
GUERIRI01 ,1971,1,Richie,Guerin,36,46,2,4,ATL,82,6,43.90243902,33.33333333,38.61788618,0,38,88
LAYDEFR01 ,1985,1,Frank,Layden,42,40,1,3,UTA,82,4,51.2195122,25,38.1097561,0,43,86
COLLIDO01 ,2001,1,Doug,Collins,37,45,0,0,WAS,82,0,45.12195122,#DIV/0!,#DIV/0!,#DIV/0!,37,82
KRUGELO01 ,2002,1,Lon,Kruger,11,16,0,0,ATL,27,0,40.74074074,#DIV/0!,#DIV/0!,#DIV/0!,11,27
STOTTTE01 ,2002,2,Terry,Stotts,24,31,0,0,ATL,55,0,43.63636364,#DIV/0!,#DIV/0!,#DIV/0!,24,55
RAMSAJA01 ,1986,1,Jack,Ramsay,41,41,1,3,IND,82,4,50,25,37.5,0,42,86
CARTWBI01 ,2002,1,Bill,Cartwright,30,52,0,0,CHI,82,0,36.58536585,#DIV/0!,#DIV/0!,#DIV/0!,30,82
LUCASJO01 ,2002,1,John,Lucas,8,34,0,0,CLE,42,0,19.04761905,#DIV/0!,#DIV/0!,#DIV/0!,8,42
SMARTKE01 ,2002,2,Keith,Smart,9,31,0,0,CLE,40,0,22.5,#DIV/0!,#DIV/0!,#DIV/0!,9,40
CHANEDO01 ,1989,1,Don,Chaney,41,41,1,3,HOU,82,4,50,25,37.5,0,42,86
BZDELJE01 ,2002,1,Jeff,Bzdelik,17,65,0,0,DEN,82,0,20.73170732,#DIV/0!,#DIV/0!,#DIV/0!,17,82
HILLBO01  ,1992,1,Bob,Hill,41,41,1,3,IND,82,4,50,25,37.5,0,42,86
MUSSEER01 ,2002,1,Eric,Musselman,38,44,0,0,GSW,82,0,46.34146341,#DIV/0!,#DIV/0!,#DIV/0!,38,82
TOMJARU01 ,2002,1,Rudy,Tomjanovich,43,39,0,0,HOU,82,0,52.43902439,#DIV/0!,#DIV/0!,#DIV/0!,43,82
SAUNDFL01 ,1998,1,Flip,Saunders,25,25,1,3,MIN,50,4,50,25,37.5,0,26,54
GENTRAL01 ,2002,1,Alvin,Gentry,19,39,0,0,LAC,58,0,32.75862069,#DIV/0!,#DIV/0!,#DIV/0!,19,58
JOHNSDE01 ,2002,2,Dennis,Johnson,8,16,0,0,LAC,24,0,33.33333333,#DIV/0!,#DIV/0!,#DIV/0!,8,24
THOMAIS01 ,2000,1,Isiah,Thomas,41,41,1,3,IND,82,4,50,25,37.5,0,42,86
LOWESI01  ,2002,1,Sidney,Lowe,0,8,0,0,MEM,8,0,0,#DIV/0!,#DIV/0!,#DIV/0!,0,8
BROWNHU01 ,2002,2,Hubie,Brown,28,46,0,0,MEM,74,0,37.83783784,#DIV/0!,#DIV/0!,#DIV/0!,28,74
RILEYPA01 ,2002,1,Pat,Riley,25,57,0,0,MIA,82,0,30.48780488,#DIV/0!,#DIV/0!,#DIV/0!,25,82
RUSSEJO01 ,1947,1,John,Russell,20,28,1,2,BOS,48,3,41.66666667,33.33333333,37.5,0,21,51
VANGUJE01 ,2003,1,Jeff,Van Gundy,45,37,1,4,HOU,82,5,54.87804878,20,37.43902439,0,46,87
SHUEGE01  ,1984,1,Gene,Shue,40,42,1,3,WA1,82,4,48.7804878,25,36.8902439,0,41,86
RAMSAJA01 ,1985,1,Jack,Ramsay,40,42,1,3,POR,82,4,48.7804878,25,36.8902439,0,41,86
CHANEDO01 ,2002,1,Don,Chaney,37,45,0,0,NYK,82,0,45.12195122,#DIV/0!,#DIV/0!,#DIV/0!,37,82
FITCHBI01 ,1991,1,Bill,Fitch,40,42,1,3,NJN,82,4,48.7804878,25,36.8902439,0,41,86
HARRILE01 ,1954,1,Les,Harrison,29,43,1,2,ROC,72,3,40.27777778,33.33333333,36.80555556,0,30,75
MCMAHJA01 ,1966,1,Jack,McMahon,39,42,1,3,CIN,81,4,48.14814815,25,36.57407407,0,40,85
STJEAGA01 ,1995,1,Garry,StJean,39,43,1,3,SAC,82,4,47.56097561,25,36.2804878,0,40,86
BZDELJE01 ,2003,1,Jeff,Bzdelik,43,39,1,4,DEN,82,5,52.43902439,20,36.2195122,0,44,87
ROCHAEP01 ,1958,1,Ephraim,Rocha,28,44,1,2,DET,72,3,38.88888889,33.33333333,36.11111111,0,29,75
MCMILNA01 ,2002,1,Nate,McMillan,40,42,0,0,SEA,82,0,48.7804878,#DIV/0!,#DIV/0!,#DIV/0!,40,82
WILKELE01 ,2002,1,Lenny,Wilkens,24,58,0,0,TOR,82,0,29.26829268,#DIV/0!,#DIV/0!,#DIV/0!,24,82
LOUGHKE01 ,1984,1,Kevin,Loughery,38,44,1,3,CHI,82,4,46.34146341,25,35.67073171,0,39,86
COLLIDO01 ,2002,1,Doug,Collins,37,45,0,0,WAS,82,0,45.12195122,#DIV/0!,#DIV/0!,#DIV/0!,37,82
STOTTTE01 ,2003,1,Terry,Stotts,28,54,0,0,ATL,82,0,34.14634146,#DIV/0!,#DIV/0!,#DIV/0!,28,82
OBRIEJI01 ,2003,1,Jim,O'Brien,22,24,0,0,BOS,46,0,47.82608696,#DIV/0!,#DIV/0!,#DIV/0!,22,46
CARROJO01 ,2003,2,John,Carroll,14,22,0,4,BOS,36,4,38.88888889,0,19.44444444,0,14,40
CARTWBI01 ,2003,1,Bill,Cartwright,4,10,0,0,CHI,14,0,28.57142857,#DIV/0!,#DIV/0!,#DIV/0!,4,14
MEYERPE01 ,2003,2,Pete,Meyers,0,2,0,0,CHI,2,0,0,#DIV/0!,#DIV/0!,#DIV/0!,0,2
SKILESC01 ,2003,3,Scott,Skiles,19,47,0,0,CHI,66,0,28.78787879,#DIV/0!,#DIV/0!,#DIV/0!,19,66
SILASPA01 ,2003,1,Paul,Silas,35,47,0,0,CLE,82,0,42.68292683,#DIV/0!,#DIV/0!,#DIV/0!,35,82
PITINRI01 ,1987,1,Rick,Pitino,38,44,1,3,NYK,82,4,46.34146341,25,35.67073171,0,39,86
RAMSAJA01 ,1969,1,Jack,Ramsay,42,40,1,4,PHI,82,5,51.2195122,20,35.6097561,0,43,87
ATTLEAL01 ,1970,1,Al,Attles,41,41,1,4,SFW,82,5,50,20,35,0,42,87
MUSSEER01 ,2003,1,Eric,Musselman,37,45,0,0,GSW,82,0,45.12195122,#DIV/0!,#DIV/0!,#DIV/0!,37,82
PORTETE01 ,2003,1,Terry,Porter,41,41,1,4,MIL,82,5,50,20,35,0,42,87
MCGUIDI01 ,1966,1,Dick,McGuire,36,45,1,3,NYK,81,4,44.44444444,25,34.72222222,0,37,85
DUNLEMI01 ,2003,1,Mike,Dunleavy,28,54,0,0,LAC,82,0,34.14634146,#DIV/0!,#DIV/0!,#DIV/0!,28,82
KARLGE01  ,1984,1,George,Karl,36,46,1,3,CLE,82,4,43.90243902,25,34.45121951,0,37,86
BROWNHU01 ,2003,1,Hubie,Brown,50,32,0,4,MEM,82,4,60.97560976,0,30.48780488,0,50,86
SUESEKE01 ,1949,1,Ken,Suesens,22,40,1,2,SHE,62,3,35.48387097,33.33333333,34.40860215,0,23,65
SHUEGE01  ,1983,1,Gene,Shue,35,47,1,3,WA1,82,4,42.68292683,25,33.84146341,0,36,86
FORDCH01  ,1994,1,Chris,Ford,35,47,1,3,BOS,82,4,42.68292683,25,33.84146341,0,36,86
SCOTTBY01 ,2003,1,Byron,Scott,22,20,0,0,NJN,42,0,52.38095238,#DIV/0!,#DIV/0!,#DIV/0!,22,42
MOTTADI01 ,1969,1,Dick,Motta,39,43,1,4,CHI,82,5,47.56097561,20,33.7804878,0,40,87
MCGUIDI01 ,1962,1,Dick,McGuire,34,46,1,3,DET,80,4,42.5,25,33.75,0,35,84
CHANEDO01 ,2003,1,Don,Chaney,15,24,0,0,NYK,39,0,38.46153846,#DIV/0!,#DIV/0!,#DIV/0!,15,39
WILKELE01 ,2003,2,Lenny,Wilkens,23,19,0,4,NYK,42,4,54.76190476,0,27.38095238,0,23,46
RIVERDO01 ,2003,1,Doc,Rivers,1,10,0,0,ORL,11,0,9.090909091,#DIV/0!,#DIV/0!,#DIV/0!,1,11
DAVISJO01 ,2003,2,Johnny,Davis,20,51,0,0,ORL,71,0,28.16901408,#DIV/0!,#DIV/0!,#DIV/0!,20,71
AYERSRA01 ,2003,1,Randy,Ayers,21,31,0,0,PHI,52,0,40.38461538,#DIV/0!,#DIV/0!,#DIV/0!,21,52
FORDCH01  ,2003,2,Chris,Ford,12,18,0,0,PHI,30,0,40,#DIV/0!,#DIV/0!,#DIV/0!,12,30
JOHNSFR01 ,2003,1,Frank,Johnson,8,13,0,0,PHO,21,0,38.0952381,#DIV/0!,#DIV/0!,#DIV/0!,8,21
DANTOMI01 ,2003,2,Mike,D'Antoni,21,40,0,0,PHO,61,0,34.42622951,#DIV/0!,#DIV/0!,#DIV/0!,21,61
CHEEKMA01 ,2003,1,Maurice,Cheeks,41,41,0,0,POR,82,0,50,#DIV/0!,#DIV/0!,#DIV/0!,41,82
GUERIRI01 ,1970,1,Richie,Guerin,36,46,1,4,ATL,82,5,43.90243902,20,31.95121951,0,37,87
KERRJO01  ,1967,1,John,Kerr,29,53,1,4,CHI,82,5,35.36585366,20,27.68292683,0,30,87
MCMILNA01 ,2003,1,Nate,McMillan,37,45,0,0,SEA,82,0,45.12195122,#DIV/0!,#DIV/0!,#DIV/0!,37,82
ONEILKE01 ,2003,1,Kevin,O'Neill,33,49,0,0,TOR,82,0,40.24390244,#DIV/0!,#DIV/0!,#DIV/0!,33,82
SLOANJE01 ,2003,1,Jerry,Sloan,42,40,0,0,UTA,82,0,51.2195122,#DIV/0!,#DIV/0!,#DIV/0!,42,82
JORDAED01 ,2003,1,Eddie,Jordan,25,57,0,0,WAS,82,0,30.48780488,#DIV/0!,#DIV/0!,#DIV/0!,25,82
